ID,Counties,Absentee by Mail Votes,Advance Voting Votes,Election Day Votes,Provisional Votes,Total
Appling 1B,1B,15,33,24,0,72
Appling 1C,1C,2,28,17,0,47
Appling 2,2,77,361,198,0,636
Appling 3A1,3A1,2,8,7,0,17
Appling 3C,3C,28,110,51,0,189
Appling 4B,4B,1,2,6,0,9
Appling 4D,4D,7,38,22,0,67
Appling 5A,5A,1,38,19,0,58
Appling 5B,5B,2,15,19,0,36
Atkinson Pearson County,Pearson County,8,55,19,0,82
Atkinson Axson,Axson,0,6,16,0,22
Atkinson Willacoochee,Willacoochee,2,97,78,0,177
Atkinson Pearson City,Pearson City,7,116,63,0,186
Bacon Douglas,Douglas,32,246,115,0,393
Baker Anna,Anna,23,83,33,0,139
Baker Elmodel,Elmodel,7,28,12,0,47
Baker Hoggards Mill,Hoggards Mill,20,83,43,1,147
Baker Milford,Milford,17,31,27,0,75
Baker Newton,Newton,15,40,34,3,92
Baldwin Scottboro,Scottboro,14,96,81,0,191
Baldwin North Baldwin,North Baldwin,53,407,129,0,589
Baldwin West Baldwin,West Baldwin,67,284,140,1,492
Baldwin East Hardwick,East Hardwick,35,201,148,0,384
Baldwin West Hardwick,West Hardwick,145,616,338,0,1099
Baldwin Coopers,Coopers,23,134,81,0,238
Baldwin South Milledgeville,South Milledgeville,62,275,106,0,443
Baldwin City Hall Annex,City Hall Annex,19,108,70,1,198
Baldwin Boddie,Boddie,51,193,132,0,376
Baldwin Courthouse,Courthouse,14,63,22,0,99
Baldwin West Thomas,West Thomas,101,343,141,0,585
Baldwin North Milledgeville,North Milledgeville,64,427,158,0,649
Baldwin Meriwether,Meriwether,58,433,155,0,646
Baldwin East Baldwin,East Baldwin,86,537,301,0,924
Banks Anderson,Anderson,5,41,23,0,69
Banks Baldwin,Baldwin,9,37,19,0,65
Banks Berlin,Berlin,0,17,9,0,26
Banks Bushville,Bushville,2,21,14,0,37
Banks Columbia,Columbia,0,7,2,0,9
Banks Davids,Davids,7,56,32,0,95
Banks Golden Hill,Golden Hill,8,27,16,0,51
Banks Grove River,Grove River,2,6,2,0,10
Banks Hollingsworth,Hollingsworth,6,21,10,0,37
Banks Homer,Homer,4,34,20,0,58
Banks Poplar Springs,Poplar Springs,9,50,22,0,81
Banks Washington,Washington,10,20,11,0,41
Banks Wilmonts,Wilmonts,2,18,8,0,28
Barrow 01,01,30,205,158,0,393
Barrow 02,02,69,380,234,0,683
Barrow 03,03,55,326,314,2,697
Barrow 04,04,34,212,125,0,371
Barrow 05,05,125,711,456,0,1292
Barrow 08,08,64,485,249,1,799
Barrow 13,13,143,1028,561,0,1732
Barrow 16,16,99,731,511,1,1342
Bartow Adairsville,Adairsville,53,427,210,1,691
Bartow Allatoona,Allatoona,40,274,160,0,474
Bartow Cartersville East,Cartersville East,106,582,303,0,991
Bartow Cartersville West,Cartersville West,107,722,332,1,1162
Bartow Cassville,Cassville,54,347,150,2,553
Bartow Center,Center,49,214,119,0,382
Bartow Emerson,Emerson,42,125,111,0,278
Bartow Euharlee,Euharlee,43,288,237,0,568
Bartow Folsom,Folsom,11,23,36,0,70
Bartow Kingston,Kingston,16,84,107,0,207
Bartow Mission Road,Mission Road,45,316,141,0,502
Bartow Pine Log,Pine Log,12,41,44,0,97
Bartow Taylorsville,Taylorsville,11,56,52,0,119
Bartow White,White,14,73,108,0,195
Bartow Zena Drive,Zena Drive,84,538,260,1,883
Bartow Hamilton Crossing,Hamilton Crossing,89,458,226,0,773
Bartow Woodland,Woodland,14,125,53,0,192
Ben Hill East,East,138,1129,413,0,1680
Berrien West Berrien,West Berrien,8,19,21,0,48
Berrien Ray City ,Ray City ,10,48,67,0,125
Berrien Nashville,Nashville,43,226,123,0,392
Berrien Enigma,Enigma,9,21,25,0,55
Berrien Alapaha ,Alapaha ,19,61,72,0,152
Bibb East Macon 1,East Macon 1,85,309,221,3,618
Bibb East Macon 2,East Macon 2,200,905,452,7,1564
Bibb East Macon 3,East Macon 3,117,598,388,1,1104
Bibb East Macon 4,East Macon 4,133,437,388,0,958
Bibb East Macon 5,East Macon 5,125,521,349,0,995
Bibb Godfrey 1,Godfrey 1,290,1228,582,7,2107
Bibb Godfrey 2,Godfrey 2,61,241,218,0,520
Bibb Godfrey 3,Godfrey 3,101,619,330,3,1053
Bibb Godfrey 4,Godfrey 4,83,270,206,0,559
Bibb Godfrey 5,Godfrey 5,154,832,653,1,1640
Bibb Hazzard 1,Hazzard 1,110,623,445,2,1180
Bibb Hazzard 2,Hazzard 2,67,541,521,5,1134
Bibb Hazzard 3,Hazzard 3,291,1477,680,7,2455
Bibb Hazzard 4,Hazzard 4,79,739,434,4,1256
Bibb Howard 1,Howard 1,87,371,199,1,658
Bibb Howard 2,Howard 2,81,381,221,6,689
Bibb Howard 3,Howard 3,145,840,526,4,1515
Bibb Howard 4,Howard 4,57,251,140,0,448
Bibb Howard 5,Howard 5,45,334,262,0,641
Bibb Howard 6,Howard 6,64,293,167,2,526
Bibb Howard 7,Howard 7,61,376,238,0,675
Bibb Rutland 1,Rutland 1,107,919,445,2,1473
Bibb Rutland 2,Rutland 2,54,398,251,1,704
Bibb Vineville 1,Vineville 1,127,547,358,1,1033
Bibb Vineville 2,Vineville 2,81,342,255,2,680
Bibb Vineville 3,Vineville 3,140,645,382,7,1174
Bibb Vineville 4,Vineville 4,193,734,557,5,1489
Bibb Vineville 5,Vineville 5,41,361,223,1,626
Bibb Vineville 6,Vineville 6,59,459,263,1,782
Bibb Warrior 1,Warrior 1,50,308,186,0,544
Bibb Warrior 2,Warrior 2,68,453,191,2,714
Bleckley 1,1,109,425,349,0,883
Brantley Hoboken,Hoboken,6,49,31,0,86
Brantley Nahunta,Nahunta,8,89,54,0,151
Brantley Waynesville,Waynesville,15,70,71,0,156
Brooks Quitman ,Quitman ,134,575,270,3,982
Brooks Barwick,Barwick,8,23,26,0,57
Brooks Dixie,Dixie,49,152,80,0,281
Brooks Briggs,Briggs,10,100,96,0,206
Brooks Pavo,Pavo,8,13,57,0,78
Brooks Nankin,Nankin,3,36,18,0,57
Brooks Morven,Morven,43,142,111,2,298
Bryan Harn Community Center,Harn Community Center,22,252,104,0,378
Bryan Danielsiding,Danielsiding,34,173,78,0,285
Bryan Christ Baptist Church,Christ Baptist Church,35,166,103,0,304
Bryan Black Creek,Black Creek,13,88,71,0,172
Bryan First Baptist Church,First Baptist Church,63,486,186,0,735
Bryan RH Rec Complex,RH Rec Complex,42,407,143,1,593
Bryan John Stevens Wetland Ctr,John Stevens Wetland Ctr,27,298,72,1,398
Bryan New Life,New Life,36,455,133,0,624
Bryan New Beginnings,New Beginnings,53,282,86,0,421
Bryan Bryan County Admin Bldg,Bryan County Admin Bldg,53,529,184,0,766
Bulloch Lockhart,Lockhart,9,41,47,0,97
Bulloch Emit,Emit,62,281,178,0,521
Bulloch Statesboro,Statesboro,120,853,445,0,1418
Bulloch Portal,Portal,20,89,106,0,215
Bulloch Fair,Fair,90,717,276,2,1085
Bulloch Church,Church,149,812,407,2,1370
Bulloch Pittman Park,Pittman Park,50,444,373,1,868
Bulloch Leefield,Leefield,12,18,46,0,76
Bulloch Blitch,Blitch,36,198,85,0,319
Bulloch Hagin,Hagin,54,218,153,2,427
Bulloch Brooklet,Brooklet,25,211,146,0,382
Bulloch Stilson,Stilson,16,57,76,0,149
Bulloch Bay,Bay,13,45,60,1,119
Bulloch Nevils,Nevils,11,47,49,0,107
Bulloch Sinkhole,Sinkhole,7,15,17,1,40
Bulloch Register,Register,16,76,67,0,159
Burke Alexander,Alexander,15,44,32,1,92
Burke Four Points,Four Points,26,194,168,1,389
Burke Girard,Girard,27,47,105,0,179
Burke Gough,Gough,18,59,64,0,141
Burke Greenscut,Greenscut,20,80,110,0,210
Burke Keysville,Keysville,7,10,77,0,94
Burke Midville,Midville,16,24,104,0,144
Burke Munnerlyn,Munnerlyn,3,18,25,0,46
Burke Sardis,Sardis,16,44,108,0,168
Burke Scotts Crossroads,Scotts Crossroads,6,32,41,0,79
Burke Telfair,Telfair,34,119,83,0,236
Burke St Clair,St Clair,16,44,44,0,104
Burke Vidette,Vidette,7,21,49,1,78
Burke North Waynesboro,North Waynesboro,133,465,296,0,894
Burke South Waynesboro,South Waynesboro,80,394,226,2,702
Burke Blakeney,Blakeney,14,80,69,1,164
Butts Butts County Recreation Center,Butts County Recreation Center,86,730,230,0,1046
Butts Jenkinsburg City Hall,Jenkinsburg City Hall,35,335,85,0,455
Butts Rock Creek Missionary,Rock Creek Missionary,35,276,93,0,404
Butts Stark United Methodist Church,Stark United Methodist Church,7,104,23,0,134
Butts Towaliga Baptist Church,Towaliga Baptist Church,21,285,75,0,381
Calhoun Leary ,Leary ,26,89,105,1,221
Calhoun Morgan,Morgan,17,54,25,0,96
Calhoun Edison ,Edison ,16,67,112,0,195
Calhoun Edison-Arlington,Edison-Arlington,11,83,88,0,182
Calhoun Arlington,Arlington,27,65,133,0,225
Camden Tarboro,Tarboro,29,46,59,1,135
Camden Waverly,Waverly,53,109,101,0,263
Camden Woodbine,Woodbine,61,204,104,0,369
Camden Browntown,Browntown,7,22,14,0,43
Camden Harriets Bluff,Harriets Bluff,14,117,65,0,196
Camden West Kingsland,West Kingsland,21,194,87,0,302
Camden North Kingsland,North Kingsland,61,304,141,0,506
Camden Kingsland,Kingsland,21,177,116,0,314
Camden East Kingsland,East Kingsland,95,763,255,0,1113
Camden North St. Marys,North St. Marys,19,108,90,0,217
Camden St. Marys ,St. Marys ,55,298,171,0,524
Camden South St. Marys,South St. Marys,68,220,105,0,393
Camden Mush Bluff,Mush Bluff,39,246,125,0,410
Camden West St. Marys ,West St. Marys ,51,313,115,0,479
Candler JSCC,JSCC,81,551,253,0,885
Carroll Kansas,Kansas,4,17,23,0,44
Carroll Bowdon,Bowdon,16,127,153,1,297
Carroll Sandhill,Sandhill,41,341,159,1,542
Carroll Center Point,Center Point,4,73,46,0,123
Carroll Mt Zion,Mt Zion,18,100,79,0,197
Carroll Burwell,Burwell,13,54,65,0,132
Carroll Clem,Clem,29,262,146,0,437
Carroll Bowdon Junction,Bowdon Junction,4,93,54,0,151
Carroll Tyus,Tyus,10,67,38,2,117
Carroll Fairfield,Fairfield,57,342,201,0,600
Carroll Hulett,Hulett,18,106,93,0,217
Carroll Bethany,Bethany,39,448,208,1,696
Carroll V R County South,V R County South,28,169,84,0,281
Carroll V R County North,V R County North,56,437,277,0,770
Carroll Villa Rica City,Villa Rica City,113,925,518,0,1556
Carroll Temple County,Temple County,31,180,134,0,345
Carroll Temple City,Temple City,50,314,285,0,649
Carroll Whitesburg,Whitesburg,13,79,75,0,167
Carroll Roopville,Roopville,23,110,91,0,224
Carroll West Carrollton,West Carrollton,54,567,305,1,927
Carroll Lakeshore Rec Center,Lakeshore Rec Center,20,218,86,0,324
Carroll Bonner,Bonner,42,411,233,0,686
Carroll University of W GA,University of W GA,7,140,136,0,283
Carroll County Admin Bldg,County Admin Bldg,44,347,123,0,514
Carroll Tabernacle Church,Tabernacle Church,29,166,98,0,293
Carroll Burson Center,Burson Center,26,152,69,0,247
Carroll Old Camp Church,Old Camp Church,18,156,90,0,264
Carroll Oak Grove,Oak Grove,14,107,54,0,175
Catoosa Blackstock,Blackstock,9,63,38,0,110
Catoosa Boynton,Boynton,39,379,201,0,619
Catoosa Catoosa Keith,Catoosa Keith,21,120,80,0,221
Catoosa Chambers,Chambers,14,142,74,0,230
Catoosa Ft Oglethorpe,Ft Oglethorpe,25,229,140,0,394
Catoosa Graysville,Graysville,56,191,184,0,431
Catoosa Lakeview,Lakeview,23,151,108,0,282
Catoosa Poplar Springs,Poplar Springs,30,214,111,0,355
Catoosa Ringgold,Ringgold,70,543,193,0,806
Catoosa Westside,Westside,47,361,148,0,556
Catoosa Woodstation,Woodstation,18,140,92,1,251
Charlton Folkston,Folkston,54,407,204,0,665
Charlton GA Bend,GA Bend,1,3,9,0,13
Charlton St. George ,St. George ,0,2,1,0,3
Charlton Homeland,Homeland,1,15,14,0,30
Charlton Racepond,Racepond,0,5,0,0,5
Charlton Winokur,Winokur,2,6,4,0,12
Chatham 1-01C First Presbyterian Church,1-01C First Presbyterian Church,125,648,531,0,1304
Chatham 1-05C JEA Building,1-05C JEA Building,76,423,338,1,838
Chatham 1-06C Central Church of Christ,1-06C Central Church of Christ,66,303,207,0,576
Chatham 1-08C Grace United Methodist Church,1-08C Grace United Methodist Church,40,223,154,0,417
Chatham 1-09C Immanuel Baptist Church,1-09C Immanuel Baptist Church,39,260,198,0,497
Chatham 1-10C St Thomas Episcopal Church,1-10C St Thomas Episcopal Church,11,76,97,0,184
Chatham 1-12C Isle of Hope Baptist,1-12C Isle of Hope Baptist,40,209,126,0,375
Chatham 1-13C The Sanctuary,1-13C The Sanctuary,46,145,132,0,323
Chatham 1-14C St. Luke United Methodist Church,1-14C St. Luke United Methodist Church,50,227,93,0,370
Chatham 1-16C Ferguson Ave Baptist,1-16C Ferguson Ave Baptist,50,218,172,0,440
Chatham 1-17C Islands Christian Church,1-17C Islands Christian Church,72,335,150,1,558
Chatham 2-02C River Pointe,2-02C River Pointe,45,273,220,0,538
Chatham 2-03C W W Law Center,2-03C W W Law Center,43,219,261,1,524
Chatham 2-04C Fellowship of Love Church,2-04C Fellowship of Love Church,124,429,438,0,991
Chatham 2-05C Holy Spirit Lutheran Church,2-05C Holy Spirit Lutheran Church,100,533,562,1,1196
Chatham 2-06C Eli Whitney Complex - Savannah,2-06C Eli Whitney Complex - Savannah,8,86,113,0,207
Chatham 2-06C Eli Whitney Complex,2-06C Eli Whitney Complex,34,129,100,0,263
Chatham 2-07C Christ Community Church,2-07C Christ Community Church,85,466,457,2,1010
Chatham 2-09C Salvation Army,2-09C Salvation Army,153,671,513,0,1337
Chatham 2-11C Oasis of Hope,2-11C Oasis of Hope,63,274,246,0,583
Chatham 2-12C Williams Court Apts,2-12C Williams Court Apts,64,269,314,1,648
Chatham 3-02C Temple Mickve Israel,3-02C Temple Mickve Israel,69,356,149,1,575
Chatham 3-03C Savannah High School,3-03C Savannah High School,32,155,209,1,397
Chatham 3-04C First African Baptist Church,3-04C First African Baptist Church,54,241,326,0,621
Chatham 3-05C New Generations Cathedral,3-05C New Generations Cathedral,46,294,322,0,662
Chatham 3-08C Jenkins High School,3-08C Jenkins High School,34,229,176,0,439
Chatham 3-09C The Connexion Church,3-09C The Connexion Church,24,69,103,0,196
Chatham 3-10C Bible Baptist Church,3-10C Bible Baptist Church,102,509,458,0,1069
Chatham 3-11C Southside Baptist Church,3-11C Southside Baptist Church,43,236,279,1,559
Chatham 3-12C Thunderbolt Muni Complex,3-12C Thunderbolt Muni Complex,55,189,217,0,461
Chatham 3-13C New Cov 7 Day Adv Ch,3-13C New Cov 7 Day Adv Ch,59,302,243,1,605
Chatham 3-14C Oglethorpe Charter Academy,3-14C Oglethorpe Charter Academy,78,474,204,0,756
Chatham 3-14C Oglethorpe Charter Academy - Savannah,3-14C Oglethorpe Charter Academy - Savannah,15,107,57,2,181
Chatham 4-02C Islands High School Annex,4-02C Islands High School Annex,47,254,146,0,447
Chatham 4-04C Lighthouse Baptist Church,4-04C Lighthouse Baptist Church,50,234,158,0,442
Chatham 4-05C St Francis Episcopal Church,4-05C St Francis Episcopal Church,66,223,152,0,441
Chatham 4-06C First Baptist of the Island,4-06C First Baptist of the Island,52,197,127,0,376
Chatham 4-07C Wilmington Island UMC,4-07C Wilmington Island UMC,57,384,192,0,633
Chatham 4-08C Wilmington Island Pres Church,4-08C Wilmington Island Pres Church,54,291,137,0,482
Chatham 4-10C Burke Day Public Safety BLDG,4-10C Burke Day Public Safety BLDG,30,155,158,0,343
Chatham 4-11C Island Old School Cafe,4-11C Island Old School Cafe,27,147,238,0,412
Chatham 4-12C St Peters Episcopal,4-12C St Peters Episcopal,69,220,183,0,472
Chatham 4-13C Skidaway Community Church,4-13C Skidaway Community Church,82,302,180,0,564
Chatham 4-14C Skidaway Island Methodist Church,4-14C Skidaway Island Methodist Church,165,471,236,0,872
Chatham 5-02C Senior Citizens Center,5-02C Senior Citizens Center,18,102,145,1,266
Chatham 5-03C Butler Presbyterian Church,5-03C Butler Presbyterian Church,59,131,227,0,417
Chatham 5-05C Liberty City Comm Ctr,5-05C Liberty City Comm Ctr,174,582,526,1,1283
Chatham 5-06C Seed Church,5-06C Seed Church,73,344,269,1,687
Chatham 5-06C Seed Church - Savannah,5-06C Seed Church - Savannah,3,29,19,0,51
Chatham 5-07C Elks Lodge,5-07C Elks Lodge,27,285,205,0,517
Chatham 5-08C Savannah Primitive BC,5-08C Savannah Primitive BC,50,275,276,2,603
Chatham 5-10C Jonesville Baptist Church,5-10C Jonesville Baptist Church,169,589,615,0,1373
Chatham 5-11C Largo-Tibet Elementary,5-11C Largo-Tibet Elementary,81,512,335,1,929
Chatham 6-01C White Bluff Presbyterian,6-01C White Bluff Presbyterian,44,287,205,1,537
Chatham 6-02C Windsor Forest Baptist - Savannah,6-02C Windsor Forest Baptist - Savannah,64,329,163,0,556
Chatham 6-02C Windsor Forest Baptist,6-02C Windsor Forest Baptist,3,13,3,0,19
Chatham 6-03C Crusader Comm Center,6-03C Crusader Comm Center,102,536,280,0,918
Chatham 6-05C Windsor Hall,6-05C Windsor Hall,47,310,252,0,609
Chatham 6-06C The Light Church,6-06C The Light Church,29,180,114,0,323
Chatham 6-08C Christ Memorial Baptist Church,6-08C Christ Memorial Baptist Church,50,382,227,0,659
Chatham 6-09C Trinity Lutheran Church,6-09C Trinity Lutheran Church,71,527,319,0,917
Chatham 6-10C Georgetown Elementary,6-10C Georgetown Elementary,139,662,342,0,1143
Chatham 6-10C Georgetown Elementary - Savannah,6-10C Georgetown Elementary - Savannah,3,26,12,1,42
Chatham 6-11C Coastal GA Botanical Gardens,6-11C Coastal GA Botanical Gardens,61,270,142,0,473
Chatham 6-11C Coastal GA Botanical Gardens - Savannah,6-11C Coastal GA Botanical Gardens - Savannah,92,657,299,0,1048
Chatham 7-01C First Baptist Church of Garden City,7-01C First Baptist Church of Garden City,27,153,133,0,313
Chatham 7-03C PB Edwards Gym,7-03C PB Edwards Gym,9,58,92,0,159
Chatham 7-04C Lake Shore Comm Ctr,7-04C Lake Shore Comm Ctr,51,489,535,3,1078
Chatham 7-05C Woodlawn Baptist Church,7-05C Woodlawn Baptist Church,27,137,134,0,298
Chatham 7-06C 1st Baptist Church of Pooler,7-06C 1st Baptist Church of Pooler,93,395,272,1,761
Chatham 7-07C Rothwell Baptist Church,7-07C Rothwell Baptist Church,94,392,195,0,681
Chatham 7-08C Bloomingdale Comm Ctr,7-08C Bloomingdale Comm Ctr,33,112,114,1,260
Chatham 7-08C Bloomingdale Comm Ctr - Savannah,7-08C Bloomingdale Comm Ctr - Savannah,6,26,15,0,47
"Chatham 7-09C Compassion Christian, Henderson","7-09C Compassion Christian, Henderson",80,351,265,2,698
"Chatham 7-09C Compassion Christian, Henderson - Savannah","7-09C Compassion Christian, Henderson - Savannah",0,0,0,0,0
Chatham 7-10C Progressive Rec Center,7-10C Progressive Rec Center,120,711,382,1,1214
Chatham 7-11C Savannah Fire Station 14,7-11C Savannah Fire Station 14,79,427,288,0,794
Chatham 7-12C West Chatham Baptist Church,7-12C West Chatham Baptist Church,97,667,284,2,1050
Chatham 7-13C Southside Fire Trng Ctr,7-13C Southside Fire Trng Ctr,114,402,135,0,651
Chatham 7-13C Southside Fire Trng Ctr - Garden City,7-13C Southside Fire Trng Ctr - Garden City,0,0,0,0,0
Chatham 7-14C Coastal Cathedral,7-14C Coastal Cathedral,259,1449,871,4,2583
Chatham 7-15C Rice Creek School,7-15C Rice Creek School,45,357,393,1,796
Chatham 7-16C Pooler Recreation Center Gymnasium,7-16C Pooler Recreation Center Gymnasium,126,648,275,0,1049
Chatham 8-01C R.M.G. Civil Rights Museum,8-01C R.M.G. Civil Rights Museum,33,227,133,0,393
Chatham 8-02C Hellenic Center,8-02C Hellenic Center,59,330,285,0,674
Chatham 8-03C Silk Hope Baptist Church,8-03C Silk Hope Baptist Church,8,56,64,1,129
Chatham 8-03C Silk Hope Baptist Church - Garden City,8-03C Silk Hope Baptist Church - Garden City,0,0,0,0,0
Chatham 8-05C W Broad St YMCA,8-05C W Broad St YMCA,31,178,216,0,425
Chatham 8-06C Tompkins Rec Center,8-06C Tompkins Rec Center,48,139,198,0,385
Chatham 8-07C Woodville-Tompkins TI,8-07C Woodville-Tompkins TI,18,79,124,0,221
Chatham 8-08C Resur of Our Lord Church,8-08C Resur of Our Lord Church,77,231,330,0,638
Chatham 8-09C Moses Jackson Center,8-09C Moses Jackson Center,72,198,263,0,533
Chatham 8-10C Carver Heights Comm Ctr,8-10C Carver Heights Comm Ctr,129,262,360,1,752
Chatham 8-11C Butler Elementary,8-11C Butler Elementary,98,307,335,1,741
Chatham 8-12C Beach High School,8-12C Beach High School,30,181,209,0,420
Chatham 8-13C Savannah Christian,8-13C Savannah Christian,18,55,42,0,115
Chatham 8-15C Cooper Center,8-15C Cooper Center,51,253,238,0,542
Chatham 8-16C Mighty 8th Museum,8-16C Mighty 8th Museum,105,474,282,0,861
Chatham 8-17C Georgia Tech Savannah Campus,8-17C Georgia Tech Savannah Campus,75,451,312,2,840
Chatham 8-18C Savannah First 7th Day Adv Church,8-18C Savannah First 7th Day Adv Church,23,133,167,0,323
Chattahoochee Activity Center,Activity Center,25,247,155,0,427
Chattooga Haywood,Haywood,0,2,5,0,7
Chattooga Lyerly,Lyerly,15,73,54,0,142
Chattooga Trion,Trion,24,141,94,0,259
Chattooga Summerville,Summerville,48,312,187,0,547
Chattooga Dirttown,Dirttown,8,44,37,0,89
Chattooga Subligna,Subligna,1,10,9,0,20
Chattooga Menlo,Menlo,7,74,47,0,128
Cherokee Air Acres,Air Acres,69,311,224,0,604
Cherokee Arnold Mill,Arnold Mill,103,423,275,0,801
Cherokee Avery,Avery,56,278,131,0,465
Cherokee Ball Ground,Ball Ground,32,207,102,0,341
Cherokee Bascomb,Bascomb,56,409,246,0,711
Cherokee Bells,Bells,102,817,385,0,1304
Cherokee Booth,Booth,77,436,180,0,693
Cherokee Bradshaw,Bradshaw,99,427,176,0,702
Cherokee Bridgemill,Bridgemill,76,422,205,0,703
Cherokee Canton,Canton,195,880,318,0,1393
Cherokee Carmel,Carmel,106,505,338,1,950
Cherokee Clayton,Clayton,81,422,149,0,652
Cherokee Conns Creek,Conns Creek,5,29,17,0,51
Cherokee Deer Run,Deer Run,62,276,239,0,577
Cherokee Dixie,Dixie,95,568,350,0,1013
Cherokee Freehome,Freehome,93,419,135,0,647
Cherokee Hickory Flat,Hickory Flat,177,739,414,0,1330
Cherokee Hightower,Hightower,29,218,76,0,323
Cherokee Hillside,Hillside,66,329,112,1,508
Cherokee Holly Springs,Holly Springs,40,183,152,0,375
Cherokee Kellogg,Kellogg,92,488,333,0,913
Cherokee Liberty,Liberty,153,753,408,0,1314
Cherokee Little River,Little River,302,901,449,0,1652
Cherokee Macedonia,Macedonia,93,319,219,0,631
Cherokee Mountain Road,Mountain Road,50,265,156,0,471
Cherokee Neese,Neese,197,905,476,0,1578
Cherokee Oak Grove,Oak Grove,67,338,155,0,560
Cherokee R M Moore,R M Moore,39,118,69,0,226
Cherokee R T Jones,R T Jones,47,168,120,0,335
Cherokee Rosecreek,Rosecreek,60,368,192,1,621
Cherokee Salacoa,Salacoa,11,12,17,0,40
Cherokee Sixes,Sixes,61,244,148,1,454
Cherokee Sutallee,Sutallee,20,88,96,0,204
Cherokee Teasley,Teasley,111,648,372,1,1132
Cherokee Toonigh,Toonigh,98,646,402,1,1147
Cherokee Union Hill,Union Hill,59,253,174,0,486
Cherokee Univeter,Univeter,52,391,149,0,592
Cherokee Victoria,Victoria,35,230,141,2,408
Cherokee Waleska,Waleska,68,256,104,0,428
Cherokee Wildcat,Wildcat,49,207,176,0,432
Cherokee Woodlands,Woodlands,60,271,385,0,716
Cherokee Woodstock,Woodstock,132,844,432,2,1410
Clarke 1A,1A,69,558,323,0,950
Clarke 1B,1B,143,860,346,0,1349
Clarke 1C,1C,128,587,314,0,1029
Clarke 1D,1D,108,725,363,0,1196
Clarke 2A,2A,165,652,543,1,1361
Clarke 2B,2B,182,962,560,0,1704
Clarke 3A,3A,98,502,330,5,935
Clarke 3B,3B,113,684,357,2,1156
Clarke 4A,4A,50,360,218,0,628
Clarke 4B,4B,94,693,428,1,1216
Clarke 5A,5A,103,833,406,0,1342
Clarke 5B,5B,124,667,415,0,1206
Clarke 5C,5C,66,713,422,0,1201
Clarke 5D,5D,82,517,493,2,1094
Clarke 6A,6A,129,726,333,3,1191
Clarke 6B,6B,169,836,384,2,1391
Clarke 6C,6C,97,617,317,0,1031
Clarke 6D,6D,67,411,279,1,758
Clarke 7A,7A,104,558,329,0,991
Clarke 7B,7B,108,620,270,0,998
Clarke 7C,7C,87,493,263,1,844
Clarke 8A,8A,122,689,357,0,1168
Clarke 8B,8B,90,472,286,1,849
Clarke 8C,8C,124,711,478,0,1313
Clay Bluffton,Bluffton,8,28,39,0,75
Clay Zetto ,Zetto ,10,49,42,0,101
Clay Court House,Court House,17,52,68,0,137
Clay Old Head Start,Old Head Start,29,60,39,0,128
Clay Days Cross Road,Days Cross Road,10,71,31,0,112
Clayton Ellenwood 1,Ellenwood 1,77,1227,284,1,1589
Clayton Ellenwood 2,Ellenwood 2,98,1375,326,0,1799
Clayton Forest Park 1,Forest Park 1,34,496,288,3,821
Clayton Forest Park 2,Forest Park 2,56,506,309,0,871
Clayton Forest Park 3,Forest Park 3,73,512,233,2,820
Clayton Forest Park 4,Forest Park 4,23,274,159,1,457
Clayton Forest Park 5,Forest Park 5,64,573,339,2,978
Clayton Forest Park 6,Forest Park 6,20,273,118,0,411
Clayton Jonesboro 1,Jonesboro 1,101,869,314,0,1284
Clayton Jonesboro 2,Jonesboro 2,50,575,197,2,824
Clayton Jonesboro 3,Jonesboro 3,31,234,95,0,360
Clayton Jonesboro 4,Jonesboro 4,33,419,211,2,665
Clayton Jonesboro 5,Jonesboro 5,43,458,216,0,717
Clayton Jonesboro 6,Jonesboro 6,101,709,126,0,936
Clayton Jonesboro 7,Jonesboro 7,89,816,324,0,1229
Clayton Jonesboro 8,Jonesboro 8,42,699,447,2,1190
Clayton Jonesboro 9,Jonesboro 9,26,277,130,0,433
Clayton Jonesboro 10,Jonesboro 10,75,631,312,2,1020
Clayton Jonesboro 11,Jonesboro 11,85,752,198,1,1036
Clayton Jonesboro 12,Jonesboro 12,71,765,317,1,1154
Clayton Jonesboro 13,Jonesboro 13,51,717,276,1,1045
Clayton Jonesboro 14,Jonesboro 14,131,1246,344,4,1725
Clayton Jonesboro 15,Jonesboro 15,22,509,222,0,753
Clayton Jonesboro 16,Jonesboro 16,52,497,297,3,849
Clayton Jonesboro 17,Jonesboro 17,87,753,305,1,1146
Clayton Jonesboro 18,Jonesboro 18,58,829,328,0,1215
Clayton Jonesboro 19,Jonesboro 19,93,913,286,2,1294
Clayton Jonesboro 20,Jonesboro 20,82,726,222,1,1031
Clayton Jonesboro 21,Jonesboro 21,106,938,296,1,1341
Clayton Jonesboro 22,Jonesboro 22,54,473,143,0,670
Clayton Lake City,Lake City,80,713,277,1,1071
Clayton Lovejoy 1,Lovejoy 1,102,1294,487,2,1885
Clayton Lovejoy 2,Lovejoy 2,68,920,324,0,1312
Clayton Lovejoy 3,Lovejoy 3,28,606,191,0,825
Clayton Lovejoy 4,Lovejoy 4,66,885,209,3,1163
Clayton Lovejoy 5,Lovejoy 5,72,879,355,1,1307
Clayton Lovejoy 6,Lovejoy 6,80,1208,362,2,1652
Clayton Lovejoy 7,Lovejoy 7,62,948,319,2,1331
Clayton Lovejoy 8,Lovejoy 8,34,521,127,0,682
Clayton Morrow 1,Morrow 1,52,633,409,2,1096
Clayton Morrow 2,Morrow 2,53,415,143,1,612
Clayton Morrow 3,Morrow 3,41,603,229,0,873
Clayton Morrow 4,Morrow 4,47,439,225,0,711
Clayton Morrow 5,Morrow 5,55,991,330,0,1376
Clayton Morrow 6,Morrow 6,62,816,279,0,1157
Clayton Morrow 7,Morrow 7,36,379,258,3,676
Clayton Morrow 8,Morrow 8,84,1038,320,1,1443
Clayton Morrow 9,Morrow 9,34,324,137,0,495
Clayton Morrow 10,Morrow 10,29,779,156,0,964
Clayton Morrow 11,Morrow 11,42,590,209,2,843
Clayton Oak 1,Oak 1,40,631,299,3,973
Clayton Oak 2,Oak 2,35,294,238,1,568
Clayton Oak 3,Oak 3,33,604,310,1,948
Clayton Oak 4,Oak 4,52,683,333,1,1069
Clayton Oak 5,Oak 5,28,300,165,2,495
Clayton Oak 6,Oak 6,13,304,114,0,431
Clayton Panhandle 1,Panhandle 1,89,1024,370,1,1484
Clayton Panhandle 2,Panhandle 2,95,1170,437,0,1702
Clayton Riverdale 1,Riverdale 1,86,884,226,0,1196
Clayton Riverdale 2,Riverdale 2,95,848,360,0,1303
Clayton Riverdale 3,Riverdale 3,64,1037,407,2,1510
Clayton Riverdale 4,Riverdale 4,118,916,411,5,1450
Clayton Riverdale 5,Riverdale 5,55,724,300,1,1080
Clayton Riverdale 6,Riverdale 6,74,520,340,2,936
Clayton Riverdale 7,Riverdale 7,35,397,290,1,723
Clayton Riverdale 8,Riverdale 8,97,1018,326,0,1441
Clayton Riverdale 9,Riverdale 9,59,592,297,0,948
Clayton Riverdale 10,Riverdale 10,33,494,274,0,801
Clayton Riverdale 11,Riverdale 11,60,649,203,1,913
Clayton Riverdale 12,Riverdale 12,97,830,361,3,1291
Clinch Arabia,Arabia,1,3,2,0,6
Clinch Argyle,Argyle,1,10,13,0,24
Clinch Dupont,Dupont,3,7,20,0,30
Clinch Fargo,Fargo,0,5,14,0,19
Clinch Homerville,Homerville,22,195,137,0,354
Cobb Acworth 1A,Acworth 1A,140,960,380,3,1483
Cobb Acworth 1B,Acworth 1B,130,760,356,0,1246
Cobb Acworth 1C,Acworth 1C,99,1025,337,8,1469
Cobb Addison 01,Addison 01,98,413,219,0,730
Cobb Austell 1A,Austell 1A,50,634,192,1,877
Cobb Austell 1B,Austell 1B,66,822,236,2,1126
Cobb Baker 01,Baker 01,74,795,459,1,1329
Cobb Bells Ferry 02,Bells Ferry 02,86,426,274,0,786
Cobb Bells Ferry 03,Bells Ferry 03,58,317,229,1,605
Cobb Bells Ferry 04,Bells Ferry 04,69,448,275,1,793
Cobb Big Shanty 01,Big Shanty 01,44,283,159,4,490
Cobb Big Shanty 02,Big Shanty 02,91,472,318,0,881
Cobb Birney 01,Birney 01,89,483,266,0,838
Cobb Birney 02,Birney 02,156,1063,357,2,1578
Cobb Bryant 01,Bryant 01,73,731,240,2,1046
Cobb Bryant 02,Bryant 02,100,1273,611,2,1986
Cobb Blackwell 01,Blackwell 01,108,450,272,0,830
Cobb Chattahoochee 01,Chattahoochee 01,108,1116,664,11,1899
Cobb Cheatham Hill 02,Cheatham Hill 02,57,568,197,0,822
Cobb Cheatham Hill 03,Cheatham Hill 03,114,838,328,1,1281
Cobb Chalker 01,Chalker 01,157,910,623,3,1693
Cobb Clarkdale 01,Clarkdale 01,51,373,169,0,593
Cobb Clarkdale 02,Clarkdale 02,128,1207,531,8,1874
Cobb Cooper 01,Cooper 01,156,1235,491,5,1887
Cobb Chestnut Ridge 01,Chestnut Ridge 01,100,497,250,0,847
Cobb Dickerson 01,Dickerson 01,113,454,239,1,807
Cobb Dobbins 01,Dobbins 01,50,350,223,3,626
Cobb Dobbins 02,Dobbins 02,82,586,397,5,1070
Cobb Dowell 01,Dowell 01,85,678,288,0,1051
Cobb Dodgen 01,Dodgen 01,74,324,209,1,608
Cobb Durham 01,Durham 01,84,537,169,0,790
Cobb Davis 01,Davis 01,55,343,228,1,627
Cobb Eastside 01,Eastside 01,141,483,217,2,843
Cobb Eastside 02,Eastside 02,187,693,278,1,1159
Cobb Elizabeth 01,Elizabeth 01,92,696,393,1,1182
Cobb Elizabeth 02,Elizabeth 02,69,339,202,1,611
Cobb Elizabeth 03,Elizabeth 03,92,444,236,0,772
Cobb Elizabeth 04,Elizabeth 04,77,416,344,2,839
Cobb Elizabeth 05,Elizabeth 05,101,507,303,1,912
Cobb East Piedmont 01,East Piedmont 01,80,393,290,1,764
Cobb Fair Oaks 02,Fair Oaks 02,154,1046,457,3,1660
Cobb Fair Oaks 04,Fair Oaks 04,121,559,419,10,1109
Cobb Fullers Park 01,Fullers Park 01,123,520,313,0,956
Cobb Ford 01,Ford 01,46,440,168,0,654
Cobb Frey 01,Frey 01,44,438,109,0,591
Cobb Garrison Mill 01,Garrison Mill 01,91,511,216,0,818
Cobb Gritters 01,Gritters 01,112,541,338,1,992
Cobb Harmony-Leland 01,Harmony-Leland 01,75,740,226,2,1043
Cobb Harmony-Leland 02,Harmony-Leland 02,129,1479,390,7,2005
Cobb Harrison 01,Harrison 01,76,414,161,1,652
Cobb Hightower 01,Hightower 01,199,713,282,0,1194
Cobb Hayes 01,Hayes 01,79,589,212,1,881
Cobb Kennesaw 1A,Kennesaw 1A,36,341,242,1,620
Cobb Kennesaw 2A,Kennesaw 2A,78,571,318,2,969
Cobb Kennesaw 3A,Kennesaw 3A,133,1204,539,11,1887
Cobb Kennesaw 4A,Kennesaw 4A,75,599,320,0,994
Cobb Kennesaw 5A,Kennesaw 5A,130,1050,631,4,1815
Cobb Kell 01,Kell 01,48,256,202,1,507
Cobb Kemp 01,Kemp 01,33,278,105,0,416
Cobb Kemp 02,Kemp 02,137,691,267,0,1095
Cobb Kemp 03,Kemp 03,77,558,183,0,818
Cobb Lassiter 01,Lassiter 01,76,607,272,0,955
Cobb Lindley 01,Lindley 01,208,1659,507,1,2375
Cobb Lost Mountain 01,Lost Mountain 01,103,803,176,0,1082
Cobb Lost Mountain 02,Lost Mountain 02,69,545,196,1,811
Cobb Lost Mountain 03,Lost Mountain 03,118,1126,223,1,1468
Cobb Lost Mountain 04,Lost Mountain 04,53,426,134,0,613
Cobb Mableton 01,Mableton 01,155,1502,406,0,2063
Cobb Mableton 02,Mableton 02,70,725,309,1,1105
Cobb Mableton 03,Mableton 03,84,598,243,1,926
Cobb Mableton 04,Mableton 04,61,359,163,0,583
Cobb Mabry 01,Mabry 01,39,237,133,0,409
Cobb Macland 01,Macland 01,133,1176,394,1,1704
Cobb Murdock 01,Murdock 01,143,693,331,0,1167
Cobb McEachern 01,McEachern 01,112,969,281,0,1362
Cobb McCleskey 01,McCleskey 01,32,281,158,0,471
Cobb McClure 01,McClure 01,57,454,207,0,718
Cobb Marietta 1A,Marietta 1A,115,668,353,2,1138
Cobb Marietta 2A,Marietta 2A,54,331,193,0,578
Cobb Marietta 2B,Marietta 2B,103,822,441,0,1366
Cobb Marietta 3A,Marietta 3A,142,797,380,0,1319
Cobb Marietta 3B,Marietta 3B,81,478,253,1,813
Cobb Marietta 4A,Marietta 4A,40,212,140,0,392
Cobb Marietta 4B,Marietta 4B,55,359,188,1,603
Cobb Marietta 4C,Marietta 4C,71,407,212,3,693
Cobb Marietta 5A,Marietta 5A,99,628,297,1,1025
Cobb Marietta 5B,Marietta 5B,45,429,308,2,784
Cobb Marietta 6A,Marietta 6A,50,374,257,1,682
Cobb Marietta 6B,Marietta 6B,106,559,316,0,981
Cobb Marietta 7A,Marietta 7A,58,517,290,1,866
Cobb Mars Hill 01,Mars Hill 01,60,346,182,0,588
Cobb Mars Hill 02,Mars Hill 02,53,395,204,0,652
Cobb Mt. Bethel 01,Mt. Bethel 01,165,637,298,0,1100
Cobb Mt. Bethel 03,Mt. Bethel 03,131,563,192,1,887
Cobb Mt. Bethel 04,Mt. Bethel 04,120,454,209,0,783
Cobb North Cobb 01,North Cobb 01,51,381,197,1,630
Cobb Nickajack 01,Nickajack 01,153,1434,602,4,2193
Cobb Norton Park 01,Norton Park 01,137,830,481,6,1454
Cobb Nicholson 01,Nicholson 01,65,334,231,0,630
Cobb Oakdale 01,Oakdale 01,170,870,425,2,1467
Cobb Oregon 01,Oregon 01,29,293,111,0,433
Cobb Oregon 02,Oregon 02,176,1305,583,4,2068
Cobb Oregon 03,Oregon 03,143,925,481,4,1553
Cobb Oregon 04,Oregon 04,200,1033,397,3,1633
Cobb Oregon 05,Oregon 05,111,963,356,2,1432
Cobb Pebblebrook 01,Pebblebrook 01,133,1286,480,4,1903
Cobb Powers Ferry 01,Powers Ferry 01,105,464,377,0,946
Cobb Pine Mountain 01,Pine Mountain 01,58,469,205,0,732
Cobb Pine Mountain 02,Pine Mountain 02,81,385,158,2,626
Cobb Post Oak 01,Post Oak 01,97,524,250,3,874
Cobb Pope 01,Pope 01,100,559,201,1,861
Cobb Palmer 01,Palmer 01,71,346,199,0,616
Cobb Powder Springs 1A,Powder Springs 1A,164,1505,412,5,2086
Cobb Powder Springs 2A,Powder Springs 2A,108,939,270,5,1322
Cobb Powder Springs 3A,Powder Springs 3A,100,1057,461,3,1621
Cobb Pitner 01,Pitner 01,57,355,288,0,700
Cobb Rocky Mount 01,Rocky Mount 01,76,495,315,1,887
Cobb Riverside 01,Riverside 01,38,409,208,6,661
Cobb Roswell 01,Roswell 01,244,883,428,0,1555
Cobb Roswell 02,Roswell 02,143,589,315,0,1047
Cobb Sandy Plains 01,Sandy Plains 01,87,510,259,0,856
Cobb Shallowford Falls 01,Shallowford Falls 01,120,545,288,0,953
Cobb Simpson 01,Simpson 01,57,310,143,0,510
Cobb Sewell Mill 01,Sewell Mill 01,142,566,305,1,1014
Cobb Sewell Mill 03,Sewell Mill 03,125,717,455,3,1300
Cobb Smyrna 1A,Smyrna 1A,89,715,548,3,1355
Cobb Smyrna 2A,Smyrna 2A,163,1238,594,10,2005
Cobb Smyrna 3A,Smyrna 3A,110,1104,411,6,1631
Cobb Smyrna 3B,Smyrna 3B,70,582,255,2,909
Cobb Smyrna 4A,Smyrna 4A,215,1421,539,5,2180
Cobb Smyrna 5A,Smyrna 5A,120,830,432,13,1395
Cobb Smyrna 6A,Smyrna 6A,213,1399,468,1,2081
Cobb Smyrna 7A,Smyrna 7A,330,2262,540,3,3135
Cobb Sope Creek 01,Sope Creek 01,60,358,209,1,628
Cobb Sope Creek 02,Sope Creek 02,174,946,439,2,1561
Cobb Sope Creek 03,Sope Creek 03,87,404,224,0,715
Cobb Sweetwater 01,Sweetwater 01,63,699,312,0,1074
Cobb Sweetwater 02,Sweetwater 02,122,606,298,0,1026
Cobb Terrell Mill 01,Terrell Mill 01,152,990,553,10,1705
Cobb Timber Ridge 01,Timber Ridge 01,111,399,220,0,730
Cobb Vaughan 01,Vaughan 01,50,382,204,2,638
Cobb Vinings 01,Vinings 01,115,626,454,1,1196
Cobb Vinings 02,Vinings 02,225,1312,666,8,2211
Cobb Vinings 03,Vinings 03,189,1107,403,2,1701
Cobb Vinings 04,Vinings 04,106,494,291,6,897
Cobb Wade Green 02,Wade Green 02,115,763,456,2,1336
Cobb Willeo 01,Willeo 01,87,501,224,0,812
Coffee Douglas,Douglas,171,1466,704,2,2343
Coffee Ambrose,Ambrose,9,98,66,0,173
Coffee Bridgetown,Bridgetown,3,11,29,0,43
Coffee Broxton,Broxton,16,118,129,2,265
Coffee Nicholls,Nicholls,16,64,100,0,180
Coffee West Green,West Green,2,8,7,0,17
Colquitt Shaw ,Shaw ,71,428,334,0,833
Colquitt Moultrie,Moultrie,71,452,264,0,787
Colquitt Autreyville,Autreyville,6,80,46,1,133
Colquitt Bridgecreek,Bridgecreek,11,30,8,0,49
Colquitt Crosland,Crosland,5,12,18,0,35
Colquitt Doerun,Doerun,3,23,71,0,97
Colquitt Funston,Funston,4,35,22,0,61
Colquitt Hamilton,Hamilton,1,10,11,0,22
Colquitt Hartsfield,Hartsfield,1,6,4,0,11
Colquitt Hopewell,Hopewell,8,53,33,1,95
Colquitt Lee,Lee,4,38,11,0,53
Colquitt Millcreek,Millcreek,0,10,8,0,18
Colquitt Monk,Monk,12,65,33,0,110
Colquitt Murphy,Murphy,6,40,11,0,57
Colquitt Norman Park,Norman Park,20,123,68,0,211
Colquitt Robinson,Robinson,4,25,23,0,52
Colquitt Thigpen,Thigpen,0,2,8,0,10
Colquitt TyTy,TyTy,2,7,7,0,16
Colquitt Warrior,Warrior,0,11,23,0,34
Columbia Kiokee Bapt Church,Kiokee Bapt Church,34,145,56,0,235
Columbia Stevens Creek Church-Grovetown,Stevens Creek Church-Grovetown,33,307,149,2,491
Columbia Lewis Methodist,Lewis Methodist,90,553,273,0,916
Columbia Woodlawn Bapt Church,Woodlawn Bapt Church,24,102,57,0,183
Columbia Patriots Park,Patriots Park,29,310,99,0,438
Columbia New Life Church,New Life Church,16,111,44,0,171
Columbia Columbia Co. Health Dept.,Columbia Co. Health Dept.,63,649,380,0,1092
Columbia Harlem Branch Library,Harlem Branch Library,35,199,119,0,353
Columbia Harlem Senior Center,Harlem Senior Center,33,195,164,0,392
Columbia Second Mount Moriah Baptist Church,Second Mount Moriah Baptist Church,6,85,51,0,142
Columbia Bessie Thomas Center,Bessie Thomas Center,11,29,19,0,59
Columbia Philadelphia Church,Philadelphia Church,43,291,196,0,530
Columbia Liberty Park-Grovetown,Liberty Park-Grovetown,49,445,250,0,744
Columbia Grovetown Methodist,Grovetown Methodist,40,406,301,1,748
Columbia G A Apostolic Church,G A Apostolic Church,26,172,127,0,325
Columbia Grovetown Dept of Public Safety Station #2,Grovetown Dept of Public Safety Station #2,89,593,364,0,1046
Columbia Grove First Baptist Church,Grove First Baptist Church,63,572,294,0,929
Columbia Eubank/Blanchard Ctr,Eubank/Blanchard Ctr,20,71,76,0,167
Columbia Second Mt. Carmel Baptist Church,Second Mt. Carmel Baptist Church,19,77,122,0,218
Columbia Damascus Bapt Church,Damascus Bapt Church,8,26,34,0,68
Columbia Col Cty Board of Edu,Col Cty Board of Edu,37,238,108,0,383
Columbia Greenbrier High,Greenbrier High,49,314,169,1,533
Columbia Parkway Baptist Church,Parkway Baptist Church,34,352,170,0,556
Columbia Riverview Church,Riverview Church,31,149,78,0,258
Columbia Grace Baptist Church,Grace Baptist Church,49,549,224,0,822
Columbia Christ Sanctified,Christ Sanctified,39,223,157,0,419
Columbia Parkway Elementary,Parkway Elementary,40,272,122,0,434
Columbia Blanchard Park,Blanchard Park,42,215,117,2,376
Columbia Belair Baptist Church,Belair Baptist Church,31,278,174,0,483
Columbia Marvin Methodist,Marvin Methodist,42,145,149,0,336
Columbia Westside Bapt Church,Westside Bapt Church,37,128,101,0,266
Columbia Trinity Bapt Church,Trinity Bapt Church,33,185,118,0,336
Columbia Abilene Baptist,Abilene Baptist,39,138,127,0,304
Columbia Augusta Christian,Augusta Christian,34,189,179,0,402
Columbia Savannah Rapids Pavilion,Savannah Rapids Pavilion,37,126,41,0,204
Columbia Gospel Water Branch,Gospel Water Branch,46,283,169,0,498
Columbia ACS-Furys Ferry Rd Campus,ACS-Furys Ferry Rd Campus,44,195,101,0,340
Columbia Stevens Creek Church,Stevens Creek Church,52,283,132,0,467
Columbia Columbia Co. Fire HDQTR,Columbia Co. Fire HDQTR,25,96,85,0,206
Columbia Lakeside Middle,Lakeside Middle,21,139,129,1,290
Columbia Martinez Baptist,Martinez Baptist,28,148,160,0,336
Columbia Gold Cross EMS,Gold Cross EMS,48,117,71,0,236
Columbia Church of Our Savior,Church of Our Savior,56,189,162,0,407
Columbia West Acres Baptist,West Acres Baptist,58,221,116,0,395
Columbia Journey Comm Church,Journey Comm Church,23,111,50,0,184
Columbia Wesley Methodist,Wesley Methodist,27,254,110,0,391
Columbia Col Cty Main Library,Col Cty Main Library,39,255,107,0,401
Columbia Christ Church Presbyterian,Christ Church Presbyterian,22,179,117,0,318
Columbia Blueridge Elementary,Blueridge Elementary,28,227,148,0,403
Columbia Christ The King Church,Christ The King Church,56,219,111,0,386
Cook Cecil,Cecil,29,213,101,0,343
Cook Delle Beamguard,Delle Beamguard,27,150,82,0,259
Cook Elm Pine,Elm Pine,27,88,90,0,205
Cook Lenox,Lenox,12,38,68,0,118
Cook Massee,Massee,8,55,24,0,87
Cook New Life Baptist Church,New Life Baptist Church,6,45,23,0,74
Cook Riverbend,Riverbend,7,50,10,0,67
Cook Sparks,Sparks,20,99,115,0,234
Coweta Senoia,Senoia,78,503,294,0,875
Coweta Moreland,Moreland,35,134,122,0,291
Coweta Pine Road,Pine Road,18,111,79,0,208
Coweta Dresden,Dresden,11,28,35,0,74
Coweta Newnan,Newnan,114,467,364,0,945
Coweta Sharpsburg,Sharpsburg,48,325,142,1,516
Coweta Fischer Road,Fischer Road,68,407,159,0,634
Coweta Grantville,Grantville,44,150,229,0,423
Coweta Haralson,Haralson,25,103,84,0,212
Coweta Welcome,Welcome,43,163,160,2,368
Coweta Panther Creek,Panther Creek,36,182,185,0,403
Coweta Raymond,Raymond,34,181,118,0,333
Coweta Turin,Turin,68,400,166,0,634
Coweta Smokey Road,Smokey Road,61,259,216,0,536
Coweta Central,Central,102,586,414,0,1102
Coweta Newnan Centre,Newnan Centre,412,2944,1261,2,4619
Coweta Greentop,Greentop,52,306,215,0,573
Coweta Expo Center,Expo Center,30,135,153,1,319
Coweta White Oak,White Oak,88,464,186,0,738
Coweta Madras,Madras,200,1122,487,1,1810
Coweta Cannongate,Cannongate,36,297,160,0,493
Coweta Westside,Westside,22,84,166,0,272
Coweta Northside,Northside,31,221,227,0,479
Coweta Thomas Crossroads,Thomas Crossroads,73,404,218,0,695
Coweta Coweta Central Library,Coweta Central Library,20,222,53,0,295
Crawford District 1,District 1,69,334,115,1,519
Crawford District 2,District 2,39,196,71,1,307
Crawford District 3,District 3,8,66,23,1,98
Crawford District 4,District 4,14,82,42,0,138
Crawford District 5,District 5,7,58,44,0,109
Crisp Arabi,Arabi,5,29,38,0,72
Crisp Coney,Coney,6,34,25,0,65
Crisp Cordele,Cordele,166,1065,561,0,1792
Crisp Jamestown,Jamestown,5,44,14,0,63
Crisp Listonia,Listonia,2,9,10,0,21
Dade South Dade,South Dade,4,36,43,0,83
Dade New Salem,New Salem,10,84,43,0,137
Dade Davis,Davis,5,33,26,0,64
Dade New Home,New Home,0,21,24,0,45
Dade West Brow,West Brow,10,54,60,0,124
Dade Trenton,Trenton,17,127,38,0,182
Dade North Dade,North Dade,17,93,62,0,172
Dawson West,West,56,250,74,0,380
Dawson Central,Central,58,423,132,0,613
Dawson East,East,88,531,214,1,834
Decatur Mt. Pleasant,Mt. Pleasant,5,21,15,0,41
Decatur Recovery,Recovery,12,42,19,0,73
Decatur Kendrick,Kendrick,7,28,29,0,64
Decatur Climax,Climax,21,64,47,1,133
Decatur Brinson,Brinson,6,45,44,1,96
Decatur West Bainbridge,West Bainbridge,37,279,119,1,436
Decatur Bainbridge-Coliseum,Bainbridge-Coliseum,40,254,141,2,437
Decatur Bainbridge-Fairgrounds,Bainbridge-Fairgrounds,78,402,267,1,748
Decatur Attapulgus,Attapulgus,65,292,217,2,576
Decatur Kirbo Center,Kirbo Center,62,388,137,0,587
DeKalb Allgood Elem,Allgood Elem,90,853,353,1,1297
DeKalb Ashford Park Elem,Ashford Park Elem,41,511,243,1,796
DeKalb Austin,Austin,81,579,171,0,831
DeKalb Avondale,Avondale,165,1213,543,0,1921
DeKalb Austin Drive,Austin Drive,96,587,275,1,959
DeKalb Ashford Dunwoody Rd,Ashford Dunwoody Rd,117,667,288,0,1072
DeKalb Ashford Parkside,Ashford Parkside,123,757,339,0,1219
DeKalb Avondale High,Avondale High,165,1370,415,1,1951
DeKalb Boulevard,Boulevard,166,2296,655,0,3117
DeKalb Briar Vista Elem,Briar Vista Elem,128,915,343,3,1389
DeKalb Briarlake Elem,Briarlake Elem,89,480,231,0,800
DeKalb Briarwood,Briarwood,40,646,169,1,856
DeKalb Brockett Elem,Brockett Elem,101,689,266,0,1056
DeKalb Briarcliff,Briarcliff,161,730,341,1,1233
DeKalb Brockett,Brockett,71,676,338,1,1086
DeKalb Brookhaven,Brookhaven,84,773,329,0,1186
DeKalb Browns Mill Elem,Browns Mill Elem,112,1492,512,0,2116
DeKalb Bouldercrest Road,Bouldercrest Road,65,767,233,0,1065
DeKalb Bethune Middle,Bethune Middle,143,1471,455,0,2069
DeKalb Burgess Elem,Burgess Elem,133,1445,549,1,2128
DeKalb Columbia Drive,Columbia Drive,91,611,279,0,981
DeKalb Canby Lane Elem,Canby Lane Elem,84,581,266,1,932
DeKalb Columbia Elem,Columbia Elem,56,263,168,1,488
DeKalb Cedar Grove Elem,Cedar Grove Elem,133,1453,404,2,1992
DeKalb Chamblee,Chamblee,44,721,180,2,947
DeKalb Candler-Murphey Candler Elem,Candler-Murphey Candler Elem,114,1291,470,1,1876
DeKalb Chapel Hill Elem,Chapel Hill Elem,111,1195,382,1,1689
DeKalb Chesnut Elem,Chesnut Elem,57,533,282,1,873
DeKalb Clairemont West,Clairemont West,262,1341,614,0,2217
DeKalb Clairmont Road,Clairmont Road,225,1015,373,0,1613
DeKalb Clarkston,Clarkston,43,616,434,2,1095
DeKalb Clifton,Clifton,77,541,181,0,799
DeKalb Columbia Middle,Columbia Middle,80,528,223,0,831
DeKalb Coan Recreation Center,Coan Recreation Center,165,1505,641,0,2311
DeKalb Cross Keys High,Cross Keys High,76,497,203,0,776
DeKalb Crossroads,Crossroads,91,939,288,0,1318
DeKalb Candler,Candler,114,1008,395,1,1518
DeKalb Cedar Grove Middle,Cedar Grove Middle,58,477,158,0,693
DeKalb Cedar Grove South,Cedar Grove South,102,1530,491,2,2125
DeKalb Covington Hwy,Covington Hwy,8,70,17,0,95
DeKalb Covington,Covington,54,628,188,1,871
DeKalb Clairemont East,Clairemont East,249,1353,433,0,2035
DeKalb Coralwood,Coralwood,223,1143,362,1,1729
DeKalb Candler Park,Candler Park,244,1951,643,0,2838
DeKalb Clarkston Community Center,Clarkston Community Center,54,540,273,1,868
DeKalb Chamblee 2,Chamblee 2,115,832,252,0,1199
DeKalb Doraville North,Doraville North,52,470,365,0,887
DeKalb Doraville South,Doraville South,29,251,161,1,442
DeKalb Dresden Elem,Dresden Elem,142,963,542,2,1649
DeKalb Decatur,Decatur,88,837,380,0,1305
DeKalb Dunaire Elem,Dunaire Elem,93,602,296,0,991
DeKalb Dunwoody,Dunwoody,98,766,273,0,1137
DeKalb Dunwoody 2,Dunwoody 2,61,506,107,0,674
DeKalb Druid Hills High,Druid Hills High,128,820,263,1,1212
DeKalb Dunwoody Library,Dunwoody Library,65,612,143,0,820
DeKalb East Lake,East Lake,220,1553,600,1,2374
DeKalb Embry Hills,Embry Hills,65,480,185,0,730
DeKalb Evansdale Elem,Evansdale Elem,123,818,374,0,1315
DeKalb Emory South,Emory South,160,1062,350,2,1574
DeKalb Emory Road,Emory Road,91,941,328,1,1361
DeKalb Fairington Elem,Fairington Elem,116,1070,612,2,1800
DeKalb Fernbank Elem,Fernbank Elem,146,848,318,0,1312
DeKalb Flat Shoals Elem,Flat Shoals Elem,102,652,243,0,997
DeKalb Flat Shoals Parkway,Flat Shoals Parkway,140,1379,325,1,1845
DeKalb Flat Rock Elem,Flat Rock Elem,79,1125,426,1,1631
DeKalb Flat Shoals,Flat Shoals,125,680,196,0,1001
DeKalb Flakes Mill,Flakes Mill,72,783,169,3,1027
DeKalb Flat Shoals Library,Flat Shoals Library,60,706,311,1,1078
DeKalb Freedom Middle,Freedom Middle,84,857,312,0,1253
DeKalb Glennwood,Glennwood,182,941,472,1,1596
DeKalb Glenhaven,Glenhaven,61,495,212,0,768
DeKalb Gresham Road,Gresham Road,152,1185,410,1,1748
DeKalb Georgetown Sq,Georgetown Sq,75,795,324,0,1194
DeKalb Glenwood Road,Glenwood Road,70,510,260,0,840
DeKalb Hambrick Elem,Hambrick Elem,106,822,409,0,1337
DeKalb Hawthorne Elem,Hawthorne Elem,105,890,492,1,1488
DeKalb Henderson Mill,Henderson Mill,142,814,322,0,1278
DeKalb Huntley Hills Elem,Huntley Hills Elem,72,731,405,0,1208
DeKalb Hugh Howell,Hugh Howell,66,465,244,0,775
DeKalb Harris-Narvie J Harris Elem,Harris-Narvie J Harris Elem,133,1567,332,1,2033
DeKalb Harris-Margaret Harris ED,Harris-Margaret Harris ED,32,383,243,0,658
DeKalb Idlewood Elem,Idlewood Elem,61,592,279,1,933
DeKalb Indian Creek,Indian Creek,72,426,188,2,688
DeKalb Johnson Estates,Johnson Estates,105,647,135,0,887
DeKalb Jolly Elem,Jolly Elem,104,762,349,1,1216
DeKalb Kelley Lake Elem,Kelley Lake Elem,105,847,356,2,1310
DeKalb Kingsley Elem,Kingsley Elem,105,531,157,0,793
DeKalb Kelley Chapel Road,Kelley Chapel Road,70,512,168,0,750
DeKalb Knollwood,Knollwood,118,658,409,1,1186
DeKalb Kittredge Elem,Kittredge Elem,90,602,187,1,880
DeKalb Lakeside High,Lakeside High,139,870,448,0,1457
DeKalb Lavista Road,Lavista Road,171,613,258,2,1044
DeKalb Lavista,Lavista,100,706,303,2,1111
DeKalb Lithonia,Lithonia,29,301,242,2,574
DeKalb Lin-Mary Lin Elem,Lin-Mary Lin Elem,188,1168,439,3,1798
DeKalb Lithonia High,Lithonia High,84,888,457,1,1430
DeKalb Livsey Elem,Livsey Elem,56,351,151,0,558
DeKalb Miller-Eldridge L Miller Elem,Miller-Eldridge L Miller Elem,133,1016,373,0,1522
DeKalb McNair High,McNair High,170,1485,495,0,2150
DeKalb Marbut Elem,Marbut Elem,104,1121,429,0,1654
DeKalb McNair,McNair,180,821,312,2,1315
DeKalb McLendon,McLendon,140,1038,433,0,1611
DeKalb McWilliams,McWilliams,90,966,317,1,1374
DeKalb Medlock,Medlock,150,872,469,1,1492
DeKalb Midvale Elem,Midvale Elem,97,742,256,0,1095
DeKalb Miller Grove,Miller Grove,119,1214,483,0,1816
DeKalb Montclair Elem,Montclair Elem,31,385,239,1,656
DeKalb Montreal,Montreal,61,651,356,0,1068
DeKalb Meadowview,Meadowview,218,1067,329,4,1618
DeKalb Memorial South,Memorial South,55,539,213,2,809
DeKalb Midway,Midway,119,869,253,0,1241
DeKalb McNair Academy,McNair Academy,87,670,263,0,1020
DeKalb Mount Vernon East,Mount Vernon East,76,588,199,0,863
DeKalb Mathis-Bob Mathis Elem,Mathis-Bob Mathis Elem,150,1084,285,0,1519
DeKalb Mount Vernon West,Mount Vernon West,62,630,150,0,842
DeKalb Metropolitan,Metropolitan,108,1359,560,0,2027
DeKalb Montgomery Elem,Montgomery Elem,88,594,281,0,963
DeKalb Miller Grove Road,Miller Grove Road,77,734,333,0,1144
DeKalb Midvale Road,Midvale Road,46,489,214,0,749
DeKalb Miller Grove High,Miller Grove High,80,826,339,1,1246
DeKalb North Decatur,North Decatur,93,566,230,0,889
DeKalb North Hairston,North Hairston,70,566,230,2,868
DeKalb Northlake,Northlake,75,432,246,0,753
DeKalb North Peachtree,North Peachtree,38,362,199,1,600
DeKalb Oak Grove Elem,Oak Grove Elem,123,627,308,0,1058
DeKalb Oakcliff Elem,Oakcliff Elem,46,242,262,0,550
DeKalb Oakhurst,Oakhurst,124,1108,481,0,1713
DeKalb Oak View Elem,Oak View Elem,120,1537,504,2,2163
DeKalb Peachcrest,Peachcrest,96,581,242,1,920
DeKalb Peachtree Middle,Peachtree Middle,91,801,306,0,1198
DeKalb Princeton Elem,Princeton Elem,55,803,290,1,1149
DeKalb Pine Lake,Pine Lake,7,96,256,0,359
DeKalb Pleasantdale Road,Pleasantdale Road,92,739,428,1,1260
DeKalb Ponce de Leon,Ponce de Leon,197,980,483,0,1660
DeKalb Panola,Panola,63,540,140,1,744
DeKalb Panola Way Elem,Panola Way Elem,49,497,235,0,781
DeKalb Piney Grove,Piney Grove,91,587,276,0,954
DeKalb Panola Road,Panola Road,93,984,328,0,1405
DeKalb Rainbow Elem,Rainbow Elem,142,1353,347,1,1843
DeKalb Redan Elem,Redan Elem,94,1091,353,1,1539
DeKalb Rehoboth,Rehoboth,116,563,212,0,891
DeKalb Rockbridge Elem,Rockbridge Elem,88,689,352,0,1129
DeKalb Rock Chapel Elem,Rock Chapel Elem,70,931,399,0,1400
DeKalb Rowland Elem,Rowland Elem,108,908,367,1,1384
DeKalb Redan-Trotti Library,Redan-Trotti Library,135,1217,436,1,1789
DeKalb Rockbridge Road,Rockbridge Road,148,1586,458,1,2193
DeKalb Rowland Road,Rowland Road,56,623,275,1,955
DeKalb Redan Road,Redan Road,90,824,302,0,1216
DeKalb Rock Chapel Road,Rock Chapel Road,125,1678,394,0,2197
DeKalb Redan Middle,Redan Middle,89,847,251,0,1187
DeKalb Sagamore Hills Elem,Sagamore Hills Elem,168,984,398,1,1551
DeKalb Scott,Scott,167,943,352,0,1462
DeKalb Shaw-Robert Shaw Elem,Shaw-Robert Shaw Elem,116,894,371,1,1382
DeKalb Stone Mountain Elem,Stone Mountain Elem,191,536,203,0,930
DeKalb Silver Lake,Silver Lake,136,1004,356,0,1496
DeKalb Skyland,Skyland,51,440,233,2,726
DeKalb Snapfinger Elem,Snapfinger Elem,110,680,267,0,1057
DeKalb Smoke Rise,Smoke Rise,85,620,188,1,894
DeKalb Stone Mtn Middle,Stone Mtn Middle,35,523,295,0,853
DeKalb Stone Mill Elem,Stone Mill Elem,65,519,357,1,942
DeKalb Shadow Rock Elem,Shadow Rock Elem,189,1690,435,1,2315
DeKalb Stoneview Elem,Stoneview Elem,55,380,212,1,648
DeKalb Salem Middle,Salem Middle,125,1495,456,0,2076
DeKalb Shamrock,Shamrock,68,528,293,0,889
DeKalb South Deshon,South Deshon,117,1074,415,1,1607
DeKalb Stone Mtn Champion,Stone Mtn Champion,67,680,350,3,1100
DeKalb Stone Mtn,Stone Mtn,48,346,204,0,598
DeKalb Snapfinger Road N,Snapfinger Road N,88,740,267,0,1095
DeKalb Snapfinger Road S,Snapfinger Road S,70,745,219,0,1034
DeKalb Stephenson Middle,Stephenson Middle,106,1336,410,0,1852
DeKalb South Hairston,South Hairston,105,964,431,1,1501
DeKalb Stephenson High,Stephenson High,131,1196,399,0,1726
DeKalb Stonecrest Library,Stonecrest Library,81,1501,467,2,2051
DeKalb Snapfinger Road,Snapfinger Road,227,2366,400,0,2993
DeKalb Terry Mill,Terry Mill,166,880,336,1,1383
DeKalb Toney Elem,Toney Elem,88,508,198,0,794
DeKalb Tucker Library,Tucker Library,121,1074,276,0,1471
DeKalb Tilly Mill Road,Tilly Mill Road,30,373,133,0,536
DeKalb Tucker,Tucker,109,879,261,1,1250
DeKalb Valley Brook,Valley Brook,37,245,255,0,537
DeKalb Wadsworth,Wadsworth,139,918,419,0,1476
DeKalb Wesley Chapel Library,Wesley Chapel Library,116,1297,223,2,1638
DeKalb Woodrow Road,Woodrow Road,64,969,343,0,1376
DeKalb Winnona Park,Winnona Park,117,890,403,0,1410
DeKalb Woodridge Elem,Woodridge Elem,164,1006,380,0,1550
DeKalb Warren Tech,Warren Tech,38,225,224,0,487
DeKalb Woodward,Woodward,117,863,341,0,1321
DeKalb White Oak,White Oak,57,612,362,0,1031
DeKalb Winters Chapel,Winters Chapel,42,318,167,0,527
DeKalb Wynbrooke Elem,Wynbrooke Elem,123,1379,459,2,1963
DeKalb Young Road,Young Road,74,803,145,1,1023
Dodge Chauncey,Chauncey,0,10,32,0,42
Dodge Clark,Clark,2,0,0,0,2
Dodge Eddin,Eddin,26,98,58,0,182
Dodge Empire,Empire,1,12,7,0,20
Dodge Jaybird,Jaybird,0,22,22,0,44
Dodge Jones,Jones,1,8,12,0,21
Dodge Lee,Lee,95,506,237,0,838
Dodge McCranie,McCranie,4,7,7,0,18
Dodge Milan,Milan,4,7,21,0,32
Dodge Mitchell,Mitchell,6,18,15,0,39
Dodge Mullis,Mullis,3,13,34,0,50
Dodge Plainfield,Plainfield,5,14,10,0,29
Dodge Pondtown,Pondtown,14,29,42,0,85
Dodge Rawlins,Rawlins,6,61,36,0,103
Dodge Vilula,Vilula,1,3,0,0,4
Dodge Yonker,Yonker,0,2,7,0,9
Dooly Lilly,Lilly,17,58,53,0,128
Dooly Byromville,Byromville,20,65,85,0,170
Dooly Unadilla,Unadilla,36,156,202,0,394
Dooly Vienna,Vienna,69,404,181,0,654
Dooly Pinehurst,Pinehurst,3,35,32,0,70
Dougherty Sherwood Elementary School,Sherwood Elementary School,46,404,377,0,827
Dougherty Covenant Church,Covenant Church,35,258,243,0,536
Dougherty Greenbriar Church,Greenbriar Church,71,792,385,0,1248
Dougherty Westover High School,Westover High School,105,908,501,0,1514
Dougherty Merry Acres Middle,Merry Acres Middle,33,312,263,0,608
Dougherty ASU West Campus,ASU West Campus,133,853,481,1,1468
Dougherty Westown Elementary School,Westown Elementary School,144,691,533,0,1368
Dougherty 2nd Mt. Zion Church,2nd Mt. Zion Church,31,159,149,0,339
Dougherty Mt. Zion Center ,Mt. Zion Center ,150,569,516,2,1237
Dougherty Alice Coachman Elementary,Alice Coachman Elementary,38,188,162,0,388
Dougherty Driskell Community Center,Driskell Community Center,42,173,260,0,475
Dougherty Shiloh Baptist Church,Shiloh Baptist Church,33,176,235,1,445
Dougherty Litman Cathedral,Litman Cathedral,43,207,248,0,498
Dougherty Phoebe Healthworks,Phoebe Healthworks,99,432,339,0,870
Dougherty Turner Elementary School,Turner Elementary School,14,65,80,0,159
Dougherty Robert H. Harvey Elementary,Robert H. Harvey Elementary,75,353,360,1,789
Dougherty Bill Miller Community Center,Bill Miller Community Center,44,345,316,0,705
Dougherty Radium Middle School,Radium Middle School,15,132,100,0,247
Dougherty Putney 1st Baptist Church,Putney 1st Baptist Church,43,343,297,0,683
Dougherty International Studies,International Studies,47,211,145,0,403
Dougherty Phoebe East ,Phoebe East ,65,351,350,2,768
Dougherty Pine Bluff Baptist Church,Pine Bluff Baptist Church,54,361,302,0,717
Dougherty Albany Middle School,Albany Middle School,68,265,290,1,624
Dougherty Christ Church,Christ Church,54,303,128,0,485
Dougherty Lamar Reese Elementary School,Lamar Reese Elementary School,59,256,212,0,527
Dougherty ASU East Campus - Lovett Hall ,ASU East Campus - Lovett Hall ,5,72,86,0,163
Douglas Mirror Lake Elementary,Mirror Lake Elementary,184,1150,666,0,2000
Douglas Winston,Winston,22,331,189,2,544
Douglas Dog River Library,Dog River Library,46,761,165,0,972
Douglas Atlanta West Pentecostal,Atlanta West Pentecostal,76,755,406,0,1237
Douglas Ephesus Baptist Church,Ephesus Baptist Church,59,413,169,0,641
Douglas Prays Mill Gym,Prays Mill Gym,98,899,326,0,1323
Douglas Turner,Turner,73,677,291,1,1042
Douglas First Baptist Lithia Springs,First Baptist Lithia Springs,38,324,158,0,520
Douglas Lithia Springs High School,Lithia Springs High School,161,1801,604,0,2566
Douglas Deer Lick,Deer Lick,50,543,197,0,790
Douglas Golden Methodist Church,Golden Methodist Church,111,1404,639,0,2154
Douglas Old Courthouse,Old Courthouse,119,1090,405,1,1615
Douglas Beulah Baptist Church,Beulah Baptist Church,67,554,283,0,904
Douglas Stewart,Stewart,80,801,363,0,1244
Douglas Arbor Station,Arbor Station,55,521,329,0,905
Douglas Bright Star,Bright Star,55,316,199,0,570
Douglas Dorsett Shoals,Dorsett Shoals,69,475,259,0,803
Douglas Chapel Hill,Chapel Hill,118,1085,441,0,1644
Douglas Church At Chapel Hill,Church At Chapel Hill,120,1735,597,1,2453
Douglas Chestnut Log,Chestnut Log,102,1062,381,0,1545
Douglas St Julians Episcopal,St Julians Episcopal,63,326,202,0,591
Douglas Lutheran Church-GS,Lutheran Church-GS,130,1138,420,0,1688
Douglas First Baptist Douglasville,First Baptist Douglasville,76,684,198,0,958
Douglas Factory Shoals,Factory Shoals,133,1568,464,2,2167
Douglas Boundary Waters,Boundary Waters,75,1440,467,0,1982
Early Arlington ,Arlington ,24,105,155,0,284
Early Blakely,Blakely,66,409,377,0,852
Early Cedar Springs ,Cedar Springs ,18,59,72,0,149
Early Cuba,Cuba,25,118,64,0,207
Early Urquhart,Urquhart,4,52,28,0,84
Echols Statenville,Statenville,2,70,22,0,94
Effingham 1A,1A,20,120,131,0,271
Effingham 1B,1B,17,121,66,0,204
Effingham 1C,1C,15,50,100,0,165
Effingham 1D,1D,23,43,71,0,137
Effingham 2A,2A,16,138,135,1,290
Effingham 2B,2B,14,94,71,0,179
Effingham 2C,2C,24,174,122,0,320
Effingham 2D,2D,40,211,165,0,416
Effingham 3A,3A,14,53,49,0,116
Effingham 3B,3B,32,142,156,0,330
Effingham 3C,3C,12,93,71,0,176
Effingham 3D,3D,37,219,207,0,463
Effingham 3E,3E,11,80,21,0,112
Effingham 4A,4A,35,247,125,0,407
Effingham 4B,4B,44,239,139,1,423
Effingham 4C,4C,15,134,72,1,222
Effingham 5A,5A,33,206,167,0,406
Effingham 5B,5B,22,124,106,1,253
Effingham 5C,5C,44,266,149,0,459
Effingham 5D,5D,22,107,125,0,254
Elbert Elberton,Elberton,86,473,265,0,824
Elbert Longstreet,Longstreet,9,50,27,1,87
Elbert Eliam,Eliam,9,38,24,2,73
Elbert Petersburg,Petersburg,2,13,19,0,34
Elbert Wyche,Wyche,11,100,56,0,167
Elbert Moss-Ruckersville,Moss-Ruckersville,16,39,27,0,82
Elbert Pike,Pike,56,180,60,3,299
Elbert Gaines,Gaines,3,22,18,0,43
Elbert Goshen,Goshen,19,65,73,0,157
Elbert Webbsboro,Webbsboro,2,27,35,0,64
Elbert Centerville,Centerville,8,37,40,1,86
Emanuel Adrian,Adrian,7,17,34,0,58
Emanuel Blundale,Blundale,0,10,9,0,19
Emanuel Canoochee,Canoochee,6,28,27,0,61
Emanuel Cross-Green,Cross-Green,5,16,71,0,92
Emanuel Garfiled,Garfiled,7,21,25,0,53
Emanuel Nunez,Nunez,3,15,14,0,32
Emanuel Oak Park,Oak Park,2,9,14,0,25
Emanuel Stillmore,Stillmore,4,32,62,0,98
Emanuel Summerton,Summerton,15,25,34,0,74
Emanuel Swainsboro,Swainsboro,115,713,402,0,1230
Emanuel Twin City,Twin City,30,115,137,0,282
Evans Veterans Community Center,Veterans Community Center,116,504,262,0,882
Fannin Colwell,Colwell,33,72,26,0,131
Fannin Fairplay,Fairplay,20,61,21,0,102
Fannin Flinthill,Flinthill,35,80,83,0,198
Fannin Hemptown,Hemptown,20,79,38,0,137
Fannin Hothouse,Hothouse,9,68,30,0,107
Fannin Mineral Bluff,Mineral Bluff,23,105,28,0,156
Fannin Mobile,Mobile,15,37,25,0,77
Fannin Morganton,Morganton,32,97,59,0,188
Fannin Noontootla,Noontootla,14,45,37,0,96
Fannin Skeniah,Skeniah,4,14,12,0,30
Fannin Sugar Creek,Sugar Creek,31,146,52,0,229
Fannin Toccoa,Toccoa,51,229,65,0,345
Fayette Blackrock,Blackrock,100,905,227,3,1235
Fayette Brooks,Brooks,22,134,68,0,224
Fayette Europe,Europe,130,1397,404,0,1931
Fayette Fayetteville East,Fayetteville East,62,503,164,0,729
Fayette Fayetteville West,Fayetteville West,72,486,166,1,725
Fayette Flint,Flint,35,501,187,0,723
Fayette Hopeful,Hopeful,54,597,240,1,892
Fayette Morning Creek,Morning Creek,99,831,279,1,1210
Fayette Rareover,Rareover,17,471,120,0,608
Fayette Sandy Creek,Sandy Creek,114,1318,404,0,1836
Fayette Shakerag East,Shakerag East,23,191,121,1,336
Fayette Shakerag West,Shakerag West,22,176,55,0,253
Fayette Starrs Mill,Starrs Mill,44,289,120,0,453
Fayette Whitewater,Whitewater,65,501,153,0,719
Fayette Woolsey,Woolsey,31,207,111,0,349
Fayette McIntosh,McIntosh,58,480,150,0,688
Fayette Oak Grove,Oak Grove,23,174,101,0,298
Fayette Kedron,Kedron,111,952,362,4,1429
Fayette Aberdeen,Aberdeen,18,206,92,1,317
Fayette Windgate,Windgate,16,110,73,0,199
Fayette Flat Creek,Flat Creek,28,264,140,0,432
Fayette Braelinn,Braelinn,15,166,76,0,257
Fayette Kenwood,Kenwood,32,304,146,0,482
Fayette Banks,Banks,37,349,169,0,555
Fayette Harps Crossing,Harps Crossing,26,319,116,2,463
Fayette Willow Pond,Willow Pond,83,650,238,1,972
Fayette Dogwood,Dogwood,61,556,204,0,821
Fayette Oak Ridge,Oak Ridge,71,553,218,0,842
Fayette Jeff Davis,Jeff Davis,59,686,225,1,971
Fayette Murphy,Murphy,82,699,276,0,1057
Fayette Fielding Ridge,Fielding Ridge,53,490,205,1,749
Fayette Willowbend,Willowbend,27,275,107,0,409
Fayette Camp Creek,Camp Creek,33,222,91,2,348
Fayette Rising Star,Rising Star,54,470,167,0,691
Fayette Spring Hill,Spring Hill,89,839,219,0,1147
Fayette Antioch,Antioch,37,256,125,1,419
Floyd Alto Park,Alto Park,56,227,151,0,434
Floyd Armuchee,Armuchee,10,54,60,0,124
Floyd Barkers,Barkers,22,85,33,0,140
Floyd Cave Spring,Cave Spring,12,63,80,1,156
Floyd Chulio,Chulio,12,42,36,3,93
Floyd Etowah,Etowah,68,338,156,0,562
Floyd Everett Springs,Everett Springs,0,12,18,0,30
Floyd Floyd Springs,Floyd Springs,6,47,40,0,93
Floyd Fosters Mill,Fosters Mill,3,37,23,0,63
Floyd Garden Lakes,Garden Lakes,20,159,75,1,255
Floyd Glenwood,Glenwood,35,163,145,0,343
Floyd Howell,Howell,7,33,41,0,81
Floyd East Lindale,East Lindale,32,212,108,0,352
Floyd Mt Alto North,Mt Alto North,71,541,256,3,871
Floyd Mt Alto South,Mt Alto South,60,390,293,0,743
Floyd North Carolina,North Carolina,12,73,58,0,143
Floyd Riverside,Riverside,7,50,60,0,117
Floyd East Rome,East Rome,77,534,262,2,875
Floyd North Rome,North Rome,83,420,191,3,697
Floyd South Rome,South Rome,41,225,178,0,444
Floyd Texas Valley,Texas Valley,3,10,20,0,33
Floyd Vanns Valley,Vanns Valley,7,26,27,0,60
Floyd Watters,Watters,20,120,105,1,246
Floyd West Lindale,West Lindale,18,136,123,0,277
Floyd Town Rome,Town Rome,55,366,202,0,623
Forsyth 01 Big Creek,01 Big Creek,178,1238,555,2,1973
Forsyth 02 Brandywine,02 Brandywine,87,575,473,1,1136
Forsyth 04 Chestatee,04 Chestatee,30,209,81,0,320
Forsyth 05 Coal Mountain,05 Coal Mountain,67,500,310,1,878
Forsyth 06 Crossroads,06 Crossroads,57,525,197,1,780
Forsyth 07 Cumming,07 Cumming,86,595,276,2,959
Forsyth 08 Mashburn,08 Mashburn,117,588,231,0,936
Forsyth 10 Midway,10 Midway,160,1136,396,0,1692
Forsyth 15 Heardsville,15 Heardsville,81,436,258,0,775
Forsyth 16 Otwell,16 Otwell,111,707,296,4,1118
Forsyth 19 Old Atlanta,19 Old Atlanta,75,305,297,1,678
Forsyth 21 South Forsyth,21 South Forsyth,47,372,197,0,616
Forsyth 25 Windermere,25 Windermere,124,925,581,0,1630
Forsyth 27 Concord,27 Concord,106,813,371,0,1290
Forsyth 34 Fowler,34 Fowler,113,670,299,0,1082
Forsyth 35 Johns Creek,35 Johns Creek,198,949,413,0,1560
Forsyth 36 Nichols,36 Nichols,125,949,414,0,1488
Forsyth 38 Daves Creek,38 Daves Creek,147,999,378,0,1524
Forsyth 39 Mathis,39 Mathis,74,433,197,1,705
Forsyth 40 West Forsyth,40 West Forsyth,90,837,273,1,1201
Forsyth 41 Grassland,41 Grassland,63,462,211,2,738
Forsyth 42 Keith Bridge,42 Keith Bridge,39,199,109,2,349
Forsyth 43 Lakeland,43 Lakeland,150,753,316,1,1220
Forsyth 44 Lanier,44 Lanier,47,267,94,0,408
Forsyth 45 Mountainside,45 Mountainside,60,424,139,1,624
Forsyth 46 Sawmill Branch,46 Sawmill Branch,68,507,189,3,767
Forsyth 47 Riverclub,47 Riverclub,33,198,157,0,388
Forsyth 49 Cheatam Creek,49 Cheatam Creek,60,393,146,0,599
Franklin Carnesville,Carnesville,6,70,40,0,116
Franklin West Franklin,West Franklin,6,34,31,0,71
Franklin Northeast Franklin,Northeast Franklin,20,105,73,0,198
Franklin Lavonia,Lavonia,29,92,97,0,218
Franklin Canon,Canon,10,31,29,0,70
Franklin Royston,Royston,20,73,80,0,173
Franklin Southwest Franklin,Southwest Franklin,13,63,26,0,102
Fulton 01A,01A,130,1455,713,1,2299
Fulton 01B,01B,124,1555,1146,2,2827
Fulton 01C,01C,32,331,220,2,585
Fulton 01D,01D,33,379,162,3,577
Fulton 01E,01E,111,1380,511,1,2003
Fulton 01F,01F,18,198,142,1,359
Fulton 01G,01G,41,711,328,2,1082
Fulton 01H,01H,36,180,99,1,316
Fulton 01I,01I,0,0,0,0,0
Fulton 01J,01J,52,601,360,1,1014
Fulton 01P,01P,28,184,273,0,485
Fulton 01R,01R,25,109,167,1,302
Fulton 01S,01S,35,406,272,1,714
Fulton 01T,01T,31,406,248,2,687
Fulton 02A,02A,138,1172,346,7,1663
Fulton 02A1,02A1,57,611,158,5,831
Fulton 02B,02B,57,514,305,1,877
Fulton 02C,02C,53,488,252,1,794
Fulton 02D,02D,121,1634,643,4,2402
Fulton 02E,02E,73,751,364,0,1188
Fulton 02F1,02F1,69,1087,379,2,1537
Fulton 02F2,02F2,17,206,87,1,311
Fulton 02G,02G,115,1298,527,4,1944
Fulton 02J,02J,80,765,281,1,1127
Fulton 02K,02K,53,497,188,1,739
Fulton 02L1,02L1,147,1502,492,1,2142
Fulton 02L1A,02L1A,71,568,353,2,994
Fulton 02L2,02L2,55,705,223,4,987
Fulton 02S,02S,17,204,111,0,332
Fulton 02W,02W,12,267,89,0,368
Fulton 03A,03A,31,354,236,1,622
Fulton 03B,03B,10,94,56,0,160
Fulton 03C,03C,37,404,160,1,602
Fulton 03D,03D,13,194,116,1,324
Fulton 03E,03E,39,384,385,1,809
Fulton 03F,03F,49,503,244,0,796
Fulton 03G,03G,8,100,89,0,197
Fulton 03H,03H,15,187,92,1,295
Fulton 03I,03I,13,333,113,1,460
Fulton 03L,03L,11,80,76,1,168
Fulton 03M,03M,15,195,250,0,460
Fulton 03N,03N,24,316,315,1,656
Fulton 03P1A,03P1A,87,1066,572,7,1732
Fulton 03P1B,03P1B,0,0,0,0,0
Fulton 03P2,03P2,4,26,9,0,39
Fulton 03S,03S,15,196,101,1,313
Fulton 03T,03T,24,338,208,3,573
Fulton 04A,04A,20,260,190,5,475
Fulton 04B,04B,26,310,193,3,532
Fulton 04C,04C,1,27,16,0,44
Fulton 04D,04D,35,428,218,1,682
Fulton 04F,04F,37,471,370,6,884
Fulton 04G,04G,14,179,127,0,320
Fulton 04I,04I,38,323,140,0,501
Fulton 04J,04J,2,78,119,11,210
Fulton 04K,04K,48,600,344,5,997
Fulton 04L,04L,21,420,275,3,719
Fulton 04M,04M,14,130,113,2,259
Fulton 04S,04S,58,599,309,4,970
Fulton 04T,04T,32,291,217,1,541
Fulton 04V,04V,40,471,403,1,915
Fulton 04W,04W,2,76,95,1,174
Fulton 04X1,04X1,44,603,273,1,921
Fulton 04X2,04X2,14,198,81,0,293
Fulton 05A1,05A1,134,1271,565,0,1970
Fulton 05A2,05A2,85,1273,589,0,1947
Fulton 05B,05B,46,448,241,1,736
Fulton 05C,05C,3,12,9,0,24
Fulton 05D,05D,3,39,33,0,75
Fulton 05F,05F,1,14,14,0,29
Fulton 05J,05J,15,231,78,0,324
Fulton 05K,05K,45,450,303,1,799
Fulton 06B,06B,43,652,202,1,898
Fulton 06D,06D,101,880,401,5,1387
Fulton 06D1,06D1,194,1317,407,1,1919
Fulton 06D2,06D2,136,946,263,1,1346
Fulton 06E,06E,49,623,289,2,963
Fulton 06F,06F,81,1078,251,0,1410
Fulton 06G,06G,15,192,54,0,261
Fulton 06I,06I,70,929,459,6,1464
Fulton 06J,06J,154,1054,331,2,1541
Fulton 06L1,06L1,54,346,93,0,493
Fulton 06L2,06L2,22,239,49,0,310
Fulton 06N,06N,53,412,170,2,637
Fulton 06Q,06Q,5,109,66,1,181
Fulton 06R,06R,70,712,122,1,905
Fulton 07A,07A,42,517,160,2,721
Fulton 07A1,07A1,144,985,416,4,1549
Fulton 07B,07B,61,599,132,1,793
Fulton 07C,07C,245,880,329,4,1458
Fulton 07D,07D,62,537,211,0,810
Fulton 07D1,07D1,32,402,170,0,604
Fulton 07E,07E,105,651,139,3,898
Fulton 07F,07F,80,791,280,2,1153
Fulton 07H,07H,77,555,131,1,764
Fulton 07J,07J,59,688,356,3,1106
Fulton 07M,07M,53,497,212,5,767
Fulton 07N,07N,50,451,181,3,685
Fulton 08A,08A,54,555,150,5,764
Fulton 08B,08B,87,757,190,2,1036
Fulton 08C,08C,4,48,6,0,58
Fulton 08C1,08C1,21,194,26,2,243
Fulton 08D,08D,21,183,34,0,238
Fulton 08E,08E,72,486,130,1,689
Fulton 08F1,08F1,50,396,96,1,543
Fulton 08F2,08F2,0,0,0,0,0
Fulton 08G,08G,120,595,167,1,883
Fulton 08H,08H,97,516,103,1,717
Fulton 08J,08J,74,681,258,3,1016
Fulton 08K,08K,23,217,98,0,338
Fulton 08L,08L,136,1212,370,1,1719
Fulton 08M,08M,52,410,156,3,621
Fulton 08N1,08N1,20,171,36,0,227
Fulton 08N2,08N2,70,394,84,1,549
Fulton 08P,08P,35,403,220,0,658
Fulton 09A,09A,84,1450,493,0,2027
Fulton 09B,09B,11,102,39,1,153
Fulton 09C,09C,75,867,320,3,1265
Fulton 09D,09D,61,411,261,1,734
Fulton 09E,09E,53,916,311,3,1283
Fulton 09F,09F,72,967,292,3,1334
Fulton 09G,09G,78,1102,490,3,1673
Fulton 09H,09H,12,263,113,2,390
Fulton 09I,09I,36,294,146,2,478
Fulton 09K,09K,35,437,176,3,651
Fulton 09K1,09K1,46,632,251,5,934
Fulton 09M,09M,47,1028,251,2,1328
Fulton 10A,10A,75,948,384,4,1411
Fulton 10B,10B,137,1738,450,3,2328
Fulton 10C,10C,29,685,220,3,937
Fulton 10D,10D,6,155,88,1,250
Fulton 10D2,10D2,50,455,96,0,601
Fulton 10D1,10D1,55,546,160,2,763
Fulton 10E,10E,39,313,132,1,485
Fulton 10F,10F,41,304,155,1,501
Fulton 10G,10G,35,527,153,0,715
Fulton 10H1,10H1,17,153,37,1,208
Fulton 10H2,10H2,45,547,227,1,820
Fulton 10I,10I,15,195,23,0,233
Fulton 10J,10J,27,165,194,2,388
Fulton 10K,10K,40,611,184,2,837
Fulton 10M,10M,67,788,409,2,1266
Fulton 10P,10P,31,337,165,2,535
Fulton 10R,10R,9,149,105,2,265
Fulton 11B,11B,104,1077,295,3,1479
Fulton 11B2,11B2,3,42,12,0,57
Fulton 11B1,11B1,49,657,210,2,918
Fulton 11C,11C,9,158,19,0,186
Fulton 11C2,11C2,37,901,141,1,1080
Fulton 11C3,11C3,20,419,26,0,465
Fulton 11E1,11E1,21,360,129,0,510
Fulton 11E2,11E2,28,356,121,1,506
Fulton 11E3,11E3,34,1150,423,2,1609
Fulton 11G,11G,48,491,172,9,720
Fulton 11H,11H,20,218,78,0,316
Fulton 11J,11J,67,537,229,0,833
Fulton 11K,11K,59,756,186,0,1001
Fulton 11M,11M,25,469,155,0,649
Fulton 11M1,11M1,29,546,155,3,733
Fulton 11N,11N,65,894,243,1,1203
Fulton 11P,11P,77,528,155,1,761
Fulton 11R,11R,20,408,170,2,600
Fulton 12A,12A,37,720,219,4,980
Fulton 12A1,12A1,54,1090,429,3,1576
Fulton 12D,12D,21,285,153,0,459
Fulton 12E1,12E1,72,300,115,0,487
Fulton 12E2,12E2,0,0,0,0,0
Fulton 12F,12F,15,209,149,0,373
Fulton 12G,12G,33,218,71,0,322
Fulton 12H1,12H1,18,122,98,1,239
Fulton 12H2,12H2,69,660,418,1,1148
Fulton 12I,12I,25,248,79,0,352
Fulton 12J,12J,60,618,361,3,1042
Fulton 12K,12K,51,803,359,7,1220
Fulton 12L,12L,9,117,76,1,203
Fulton 12M,12M,47,514,438,2,1001
Fulton 12N,12N,9,190,116,2,317
Fulton 12S,12S,34,491,255,1,781
Fulton AP01A,AP01A,111,1000,334,2,1447
Fulton AP01B,AP01B,22,221,114,0,357
Fulton AP01C,AP01C,52,480,120,3,655
Fulton AP01D,AP01D,17,177,69,0,263
Fulton AP01E,AP01E,0,0,0,0,0
Fulton AP021,AP021,62,597,223,0,882
Fulton AP022,AP022,56,332,151,0,539
Fulton AP023,AP023,30,173,36,0,239
Fulton AP02B,AP02B,29,134,29,1,193
Fulton AP03,AP03,11,83,79,0,173
Fulton AP04A,AP04A,30,336,78,0,444
Fulton AP04B,AP04B,7,104,29,0,140
Fulton AP05,AP05,121,885,286,0,1292
Fulton AP06,AP06,36,351,82,0,469
Fulton AP07A,AP07A,86,660,238,2,986
Fulton AP07C,AP07C,17,136,66,1,220
Fulton AP07B,AP07B,22,167,93,0,282
Fulton AP09A,AP09A,102,847,308,1,1258
Fulton AP09B,AP09B,21,234,61,0,316
Fulton AP10,AP10,16,164,48,0,228
Fulton AP12A,AP12A,8,132,49,2,191
Fulton AP12B,AP12B,29,172,81,1,283
Fulton AP12C,AP12C,39,410,101,2,552
Fulton AP12D,AP12D,0,0,0,0,0
Fulton AP14,AP14,1,32,13,0,46
Fulton AP14A,AP14A,91,683,162,3,939
Fulton CH01,CH01,2,91,15,0,108
Fulton CH02,CH02,6,130,26,0,162
Fulton CH03,CH03,4,51,19,2,76
Fulton CH04A,CH04A,11,241,47,0,299
Fulton CH04B,CH04B,0,3,0,0,3
Fulton CH05,CH05,3,48,22,0,73
Fulton CP011,CP011,35,384,102,1,522
Fulton CP012,CP012,36,530,109,1,676
Fulton CP01B,CP01B,8,141,30,1,180
Fulton CP02,CP02,44,355,102,0,501
Fulton CP04A,CP04A,0,2,0,0,2
Fulton CP04B,CP04B,0,13,0,0,13
Fulton CP051,CP051,0,16,12,0,28
Fulton CP05C,CP05C,27,490,212,0,729
Fulton CP052,CP052,0,0,0,0,0
Fulton CP05B,CP05B,0,27,16,0,43
Fulton CP06A,CP06A,3,69,42,0,114
Fulton CP06B,CP06B,1,1,0,0,2
Fulton CP07A,CP07A,2,73,39,1,115
Fulton CP07B,CP07B,0,3,2,0,5
Fulton CP07C,CP07C,0,30,18,0,48
Fulton CP07D,CP07D,1,25,16,0,42
Fulton CP07E,CP07E,0,11,10,0,21
Fulton CP07F,CP07F,0,18,15,0,33
Fulton CP081,CP081,3,35,26,1,65
Fulton CP083,CP083,0,23,18,0,41
Fulton CP084,CP084,0,0,0,0,0
Fulton CP08A,CP08A,3,39,45,1,88
Fulton EP01A,EP01A,41,873,287,2,1203
Fulton EP01B,EP01B,62,665,172,3,902
Fulton EP01C,EP01C,16,312,134,3,465
Fulton EP02A,EP02A,47,531,218,1,797
Fulton EP02B,EP02B,40,636,145,1,822
Fulton EP02C,EP02C,8,167,41,0,216
Fulton EP02D,EP02D,6,191,70,0,267
Fulton EP02E,EP02E,22,356,132,3,513
Fulton EP03A,EP03A,116,1532,455,3,2106
Fulton EP03B,EP03B,42,597,166,1,806
Fulton EP04A,EP04A,25,617,328,4,974
Fulton EP04B,EP04B,39,861,260,3,1163
Fulton EP04C,EP04C,64,869,208,2,1143
Fulton FA01A,FA01A,80,1346,335,5,1766
Fulton FA01B,FA01B,107,2150,524,7,2788
Fulton FA01C,FA01C,22,212,93,1,328
Fulton FA01D,FA01D,7,122,30,0,159
Fulton FC02,FC02,0,10,6,1,17
Fulton HP01,HP01,44,786,451,2,1283
Fulton JC01,JC01,104,837,282,3,1226
Fulton JC01A,JC01A,44,387,197,2,630
Fulton JC02,JC02,72,577,226,1,876
Fulton JC03A,JC03A,6,146,40,1,193
Fulton JC03B,JC03B,24,314,141,2,481
Fulton JC04A,JC04A,76,753,137,1,967
Fulton JC04B,JC04B,9,75,20,2,106
Fulton JC04C,JC04C,24,325,76,1,426
Fulton JC05,JC05,25,503,141,0,669
Fulton JC06,JC06,59,421,187,0,667
Fulton JC07,JC07,121,954,283,3,1361
Fulton JC08,JC08,56,644,194,4,898
Fulton JC09,JC09,73,742,228,1,1044
Fulton JC10,JC10,80,539,177,0,796
Fulton JC11,JC11,47,586,195,1,829
Fulton JC12,JC12,59,463,72,1,595
Fulton JC13A,JC13A,48,358,107,0,513
Fulton JC13B,JC13B,1,28,12,0,41
Fulton JC14,JC14,56,518,107,0,681
Fulton JC15,JC15,18,188,63,0,269
Fulton JC16,JC16,51,613,185,0,849
Fulton JC18,JC18,61,577,152,0,790
Fulton JC19A,JC19A,51,665,142,1,859
Fulton JC19,JC19,40,304,103,1,448
Fulton ML01A,ML01A,36,524,149,2,711
Fulton ML01B,ML01B,5,103,24,1,133
Fulton ML01C,ML01C,4,21,3,0,28
Fulton ML02A,ML02A,53,265,95,0,413
Fulton ML02B,ML02B,30,288,53,0,371
Fulton ML03,ML03,45,457,157,1,660
Fulton ML03A,ML03A,8,62,12,0,82
Fulton ML04,ML04,50,537,138,1,726
Fulton ML05,ML05,86,877,289,4,1256
Fulton ML06A,ML06A,42,391,180,2,615
Fulton ML06B,ML06B,57,646,237,3,943
Fulton ML07A,ML07A,7,113,52,1,173
Fulton ML07B,ML07B,18,229,70,1,318
Fulton MP01,MP01,10,31,121,0,162
Fulton PA01,PA01,39,851,235,1,1126
Fulton RW01,RW01,123,920,284,4,1331
Fulton RW02,RW02,81,844,307,2,1234
Fulton RW03,RW03,15,82,39,0,136
Fulton RW03B,RW03B,38,394,143,2,577
Fulton RW03A,RW03A,13,134,41,0,188
Fulton RW03C,RW03C,25,367,147,4,543
Fulton RW04,RW04,45,483,110,0,638
Fulton RW05,RW05,34,362,200,0,596
Fulton RW05A,RW05A,19,149,80,1,249
Fulton RW06,RW06,49,685,264,0,998
Fulton RW07A,RW07A,20,226,192,0,438
Fulton RW07B,RW07B,7,55,66,0,128
Fulton RW08,RW08,62,392,137,0,591
Fulton RW09,RW09,100,615,214,1,930
Fulton RW09A,RW09A,53,404,139,1,597
Fulton RW10,RW10,58,442,170,0,670
Fulton RW10A,RW10A,26,198,41,0,265
Fulton RW11A,RW11A,62,575,187,0,824
Fulton RW11B,RW11B,0,0,0,0,0
Fulton RW12,RW12,57,542,234,0,833
Fulton RW12A,RW12A,63,643,204,1,911
Fulton RW13,RW13,53,769,275,0,1097
Fulton RW16,RW16,49,435,137,1,622
Fulton RW17,RW17,48,695,287,0,1030
Fulton RW19,RW19,48,373,130,0,551
Fulton RW20,RW20,36,701,149,1,887
Fulton RW21,RW21,4,17,2,1,24
Fulton RW21A,RW21A,53,606,137,1,797
Fulton RW22A,RW22A,67,961,357,3,1388
Fulton RW22C,RW22C,0,0,0,0,0
Fulton RW22B,RW22B,0,0,0,0,0
Fulton SC01A,SC01A,0,14,3,0,17
Fulton SC01B,SC01B,50,1084,223,0,1357
Fulton SC01C,SC01C,63,1281,166,0,1510
Fulton SC02,SC02,17,402,28,0,447
Fulton SC02A,SC02A,14,397,49,0,460
Fulton SC04,SC04,9,313,90,0,412
Fulton SC05A,SC05A,16,268,70,0,354
Fulton SC05B,SC05B,21,526,92,7,646
Fulton SC05C,SC05C,38,1124,240,1,1403
Fulton SC05D,SC05D,48,1322,286,3,1659
Fulton SC05E,SC05E,19,246,56,0,321
Fulton SC07A,SC07A,113,1614,318,3,2048
Fulton SC07B,SC07B,0,1,0,0,1
Fulton SC07C,SC07C,0,5,0,0,5
Fulton SC07D,SC07D,10,340,81,2,433
Fulton SC07E,SC07E,48,663,140,2,853
Fulton SC08A,SC08A,0,3,0,0,3
Fulton SC08J,SC08J,2,12,4,0,18
Fulton SC08B,SC08B,77,1467,379,1,1924
Fulton SC08I,SC08I,4,53,16,0,73
Fulton SC08C,SC08C,1,43,6,0,50
Fulton SC08D,SC08D,13,211,48,0,272
Fulton SC08E,SC08E,4,236,93,2,335
Fulton SC08F,SC08F,9,251,50,0,310
Fulton SC08G,SC08G,0,2,0,0,2
Fulton SC08H,SC08H,0,0,0,0,0
Fulton SC09A,SC09A,31,528,141,0,700
Fulton SC09B,SC09B,64,742,167,1,974
Fulton SC09C,SC09C,55,580,162,3,800
Fulton SC10,SC10,27,344,158,6,535
Fulton SC11A,SC11A,36,580,165,0,781
Fulton SC11B,SC11B,60,612,181,4,857
Fulton SC13,SC13,36,832,163,0,1031
Fulton SC13A,SC13A,23,399,88,1,511
Fulton SC14A,SC14A,18,309,61,1,389
Fulton SC15,SC15,84,1400,375,2,1861
Fulton SC15A,SC15A,58,1539,331,4,1932
Fulton SC16A,SC16A,49,1175,263,3,1490
Fulton SC16B,SC16B,60,1062,224,4,1350
Fulton SC17A,SC17A,1,26,7,0,34
Fulton SC17B,SC17B,0,0,0,0,0
Fulton SC17C,SC17C,13,499,97,0,609
Fulton SC18A,SC18A,28,224,41,0,293
Fulton SC18B,SC18B,35,617,114,3,769
Fulton SC18C,SC18C,42,897,124,2,1065
Fulton SC18D,SC18D,4,181,24,1,210
Fulton SC19A,SC19A,3,91,13,0,107
Fulton SC19B,SC19B,33,418,151,0,602
Fulton SC20,SC20,63,1416,174,2,1655
Fulton SC211,SC211,33,714,221,0,968
Fulton SC212,SC212,85,1474,451,3,2013
Fulton SC21A,SC21A,0,0,0,0,0
Fulton SC23A,SC23A,94,1151,447,0,1692
Fulton SC23B,SC23B,19,180,60,2,261
Fulton SC23C,SC23C,52,761,282,1,1096
Fulton SC27,SC27,72,866,183,0,1121
Fulton SC29A,SC29A,71,961,333,4,1369
Fulton SC29B,SC29B,0,0,0,1,1
Fulton SC30A,SC30A,19,71,8,0,98
Fulton SC30B,SC30B,22,330,70,2,424
Fulton SC31,SC31,3,148,36,0,187
Fulton SC32,SC32,2,5,4,0,11
Fulton SC33,SC33,1,8,1,0,10
Fulton SS01,SS01,98,726,187,0,1011
Fulton SS01A,SS01A,35,244,39,0,318
Fulton SS02A,SS02A,29,296,87,1,413
Fulton SS02B,SS02B,14,339,95,2,450
Fulton SS03A,SS03A,15,181,78,0,274
Fulton SS03,SS03,25,158,48,1,232
Fulton SS04A,SS04A,1,46,14,0,61
Fulton SS04,SS04,86,820,284,2,1192
Fulton SS05,SS05,45,481,119,1,646
Fulton SS06,SS06,50,395,95,0,540
Fulton SS07A,SS07A,42,294,36,0,372
Fulton SS07B,SS07B,16,221,80,0,317
Fulton SS07C,SS07C,29,145,32,0,206
Fulton SS07D,SS07D,0,0,0,0,0
Fulton SS08A,SS08A,36,314,244,1,595
Fulton SS08B,SS08B,18,155,40,2,215
Fulton SS08E,SS08E,9,88,24,0,121
Fulton SS08C,SS08C,9,173,59,0,241
Fulton SS08D,SS08D,35,360,120,2,517
Fulton SS09A,SS09A,110,640,122,0,872
Fulton SS09B,SS09B,126,822,140,1,1089
Fulton SS11A,SS11A,76,780,319,6,1181
Fulton SS11B,SS11B,33,270,113,2,418
Fulton SS11C,SS11C,0,91,47,1,139
Fulton SS11D,SS11D,12,93,16,0,121
Fulton SS12,SS12,85,586,179,2,852
Fulton SS13A,SS13A,37,413,183,1,634
Fulton SS13B,SS13B,25,246,109,2,382
Fulton SS14,SS14,25,253,86,1,365
Fulton SS15A,SS15A,27,479,257,2,765
Fulton SS15B,SS15B,24,305,194,0,523
Fulton SS16,SS16,54,442,114,1,611
Fulton SS17,SS17,88,636,262,1,987
Fulton SS18A,SS18A,14,90,15,0,119
Fulton SS18C,SS18C,10,64,18,0,92
Fulton SS18B,SS18B,10,62,20,0,92
Fulton SS19A,SS19A,40,698,285,1,1024
Fulton SS19B,SS19B,35,560,131,0,726
Fulton SS20,SS20,40,501,166,2,709
Fulton SS22,SS22,77,483,151,1,712
Fulton SS26,SS26,47,760,335,6,1148
Fulton SS29A,SS29A,80,619,236,4,939
Fulton SS29B,SS29B,0,0,0,0,0
Fulton SS31,SS31,51,452,123,1,627
Fulton UC01A,UC01A,55,925,331,6,1317
Fulton UC01B,UC01B,3,85,45,0,133
Fulton UC01C,UC01C,0,1,0,0,1
Fulton UC01D,UC01D,0,0,0,0,0
Fulton UC01E,UC01E,13,231,66,1,311
Fulton UC02A,UC02A,44,233,52,2,331
Fulton UC02E,UC02E,79,1543,425,2,2049
Fulton UC02B,UC02B,0,7,4,0,11
Fulton UC02C,UC02C,3,20,19,0,42
Fulton UC02D,UC02D,65,1321,336,9,1731
Fulton UC031,UC031,69,690,251,2,1012
Fulton UC032,UC032,16,134,49,0,199
Fulton UC033,UC033,0,0,0,0,0
Fulton UC035,UC035,0,2,0,0,2
Gilmer Ellijay South,Ellijay South,48,179,78,0,305
Gilmer Cartecay,Cartecay,18,60,31,0,109
Gilmer Tails Creek,Tails Creek,8,53,38,0,99
Gilmer Town Creek,Town Creek,15,24,44,0,83
Gilmer Leaches,Leaches,35,194,63,0,292
Gilmer Cherry Log,Cherry Log,16,60,50,0,126
Gilmer Boardtown,Boardtown,21,89,41,0,151
Gilmer Mountaintown,Mountaintown,12,61,43,0,116
Gilmer East Ellijay,East Ellijay,18,87,35,0,140
Gilmer Ellijay North,Ellijay North,12,84,36,1,133
Gilmer Yukon,Yukon,6,59,37,0,102
Gilmer Roy Road,Roy Road,22,92,41,0,155
Gilmer Ellijay Northeast,Ellijay Northeast,32,130,37,0,199
Glascock Edgehill,Edgehill,0,5,2,0,7
Glascock Gibson,Gibson,3,19,15,0,37
Glascock Mill,Mill,1,14,5,0,20
Glascock Mitchell,Mitchell,1,3,21,0,25
Glynn SES,SES,73,357,134,1,565
Glynn BRK,BRK,41,311,130,0,482
Glynn MAR,MAR,32,247,124,0,403
Glynn BLY,BLY,20,118,50,1,189
Glynn NSSI,NSSI,70,629,147,0,846
Glynn CSSI,CSSI,111,769,154,0,1034
Glynn SSSI,SSSI,75,640,95,0,810
Glynn JI,JI,29,71,117,0,217
Glynn COG,COG,55,352,159,1,567
Glynn SEB,SEB,16,153,83,2,254
Glynn GICCA,GICCA,52,227,137,0,416
Glynn NGLY,NGLY,65,329,141,0,535
Glynn BAL,BAL,43,286,143,0,472
Glynn NSB,NSB,99,465,262,0,826
Glynn THE,THE,78,365,166,0,609
Glynn CPM,CPM,71,308,162,0,541
Glynn HCP,HCP,74,493,226,3,796
Glynn UPP,UPP,147,556,280,0,983
Glynn ARCO,ARCO,32,127,74,1,234
Gordon Sugar Valley,Sugar Valley,3,36,33,0,72
Gordon Plainville,Plainville,16,47,62,1,126
Gordon Sonoraville,Sonoraville,17,157,150,0,324
Gordon Pine Chapel,Pine Chapel,6,22,22,0,50
Gordon Oostanaula,Oostanaula,5,29,30,0,64
Gordon Oakman,Oakman,2,29,43,0,74
Gordon Gordon County,Gordon County,36,239,183,1,459
Gordon Calhoun City,Calhoun City,78,644,344,0,1066
Gordon Lily Pond,Lily Pond,13,62,53,0,128
Gordon Fairmount,Fairmount,5,39,56,0,100
Gordon Red Bud,Red Bud,18,105,83,0,206
Gordon Resaca,Resaca,8,24,42,0,74
Grady Blowing Cave,Blowing Cave,5,30,23,0,58
Grady Cairo 4th District,Cairo 4th District,93,531,262,1,887
Grady Cairo 5th District,Cairo 5th District,39,283,143,0,465
Grady Duncanville ,Duncanville ,14,56,22,0,92
Grady Higdon,Higdon,15,61,72,0,148
Grady Limesink,Limesink,3,25,3,0,31
Grady Midway,Midway,14,103,37,0,154
Grady Pine Park ,Pine Park ,11,64,62,0,137
Grady Ragan,Ragan,8,46,29,0,83
Grady Spence,Spence,3,20,13,0,36
Grady Spring Hill,Spring Hill,6,17,12,0,35
Grady Whigham,Whigham,16,73,49,0,138
Grady Woodland,Woodland,17,109,32,0,158
Greene Greensboro,Greensboro,132,669,328,0,1129
Greene Union Point,Union Point,51,192,249,0,492
Greene Siloam,Siloam,19,95,143,0,257
Greene White Plains,White Plains,12,52,43,0,107
Greene Old Salem,Old Salem,144,780,151,0,1075
Gwinnett HARBINS A,HARBINS A,130,1486,570,1,2187
Gwinnett ROCKBRIDGE A,ROCKBRIDGE A,103,1084,395,3,1585
Gwinnett DACULA,DACULA,109,938,344,4,1395
Gwinnett SUWANEE A,SUWANEE A,29,348,167,1,545
Gwinnett BAYCREEK A,BAYCREEK A,57,453,262,1,773
Gwinnett GOODWINS A,GOODWINS A,102,608,384,1,1095
Gwinnett DULUTH A,DULUTH A,159,1047,407,2,1615
Gwinnett DUNCANS A,DUNCANS A,104,687,236,2,1029
Gwinnett PUCKETTS A,PUCKETTS A,78,807,238,0,1123
Gwinnett CATES A,CATES A,62,425,131,0,618
Gwinnett BERKSHIRE A,BERKSHIRE A,61,374,251,1,687
Gwinnett BERKSHIRE B,BERKSHIRE B,110,1041,410,1,1562
Gwinnett DUNCANS C,DUNCANS C,43,348,184,1,576
Gwinnett GARNERS A,GARNERS A,68,682,266,0,1016
Gwinnett LAWRENCEVILLE A,LAWRENCEVILLE A,108,610,317,0,1035
Gwinnett LAWRENCEVILLE B,LAWRENCEVILLE B,150,1108,426,0,1684
Gwinnett MARTINS A,MARTINS A,72,483,361,2,918
Gwinnett MARTINS B,MARTINS B,44,431,364,0,839
Gwinnett MARTINS C,MARTINS C,65,411,313,0,789
Gwinnett PINCKNEYVILLE A,PINCKNEYVILLE A,54,414,316,1,785
Gwinnett PINCKNEYVILLE B,PINCKNEYVILLE B,62,570,281,2,915
Gwinnett PINCKNEYVILLE C,PINCKNEYVILLE C,77,383,220,0,680
Gwinnett PINCKNEYVILLE D,PINCKNEYVILLE D,25,299,206,1,531
Gwinnett SUGAR HILL A,SUGAR HILL A,65,521,274,1,861
Gwinnett SUGAR HILL B,SUGAR HILL B,95,728,501,1,1325
Gwinnett HOG MOUNTAIN A,HOG MOUNTAIN A,118,790,504,1,1413
Gwinnett HOG MOUNTAIN B,HOG MOUNTAIN B,107,710,370,1,1188
Gwinnett ROCKYCREEK A,ROCKYCREEK A,92,1044,419,4,1559
Gwinnett CATES B,CATES B,23,242,138,1,404
Gwinnett CATES C,CATES C,61,642,273,0,976
Gwinnett HOG MOUNTAIN D,HOG MOUNTAIN D,79,411,224,0,714
Gwinnett BERKSHIRE D,BERKSHIRE D,64,554,236,0,854
Gwinnett BERKSHIRE E,BERKSHIRE E,47,353,161,0,561
Gwinnett BERKSHIRE F,BERKSHIRE F,44,266,223,0,533
Gwinnett CATES D,CATES D,92,667,409,0,1168
Gwinnett CATES E,CATES E,90,614,243,1,948
Gwinnett PINCKNEYVILLE E,PINCKNEYVILLE E,29,293,247,1,570
Gwinnett PINCKNEYVILLE F,PINCKNEYVILLE F,49,353,312,0,714
Gwinnett DUNCANS D,DUNCANS D,164,847,386,1,1398
Gwinnett PINCKNEYVILLE H,PINCKNEYVILLE H,126,1021,323,0,1470
Gwinnett BAYCREEK B,BAYCREEK B,142,1388,674,1,2205
Gwinnett LAWRENCEVILLE C,LAWRENCEVILLE C,61,385,216,0,662
Gwinnett MARTINS D,MARTINS D,48,323,248,0,619
Gwinnett ROCKBRIDGE B,ROCKBRIDGE B,93,957,389,0,1439
Gwinnett GARNERS B,GARNERS B,82,772,305,1,1160
Gwinnett CATES F,CATES F,48,212,170,0,430
Gwinnett CATES G,CATES G,85,479,271,1,836
Gwinnett DULUTH B,DULUTH B,94,529,227,2,852
Gwinnett GARNERS C,GARNERS C,31,355,199,0,585
Gwinnett PINCKNEYVILLE I,PINCKNEYVILLE I,33,334,219,2,588
Gwinnett PINCKNEYVILLE J,PINCKNEYVILLE J,32,370,222,0,624
Gwinnett BERKSHIRE G,BERKSHIRE G,27,523,154,1,705
Gwinnett CATES H,CATES H,71,786,400,1,1258
Gwinnett SUGAR HILL C,SUGAR HILL C,74,647,357,0,1078
Gwinnett SUGAR HILL D,SUGAR HILL D,82,640,234,0,956
Gwinnett DULUTH C,DULUTH C,57,367,167,0,591
Gwinnett DULUTH D,DULUTH D,103,897,361,3,1364
Gwinnett PINCKNEYVILLE K,PINCKNEYVILLE K,47,525,320,2,894
Gwinnett PINCKNEYVILLE N,PINCKNEYVILLE N,47,699,464,0,1210
Gwinnett LAWRENCEVILLE D,LAWRENCEVILLE D,63,829,395,5,1292
Gwinnett LAWRENCEVILLE E,LAWRENCEVILLE E,68,341,164,1,574
Gwinnett PINCKNEYVILLE L,PINCKNEYVILLE L,77,386,169,0,632
Gwinnett PINCKNEYVILLE M,PINCKNEYVILLE M,70,385,185,0,640
Gwinnett GARNERS D,GARNERS D,97,885,356,1,1339
Gwinnett BERKSHIRE H,BERKSHIRE H,28,273,162,0,463
Gwinnett PINCKNEYVILLE O,PINCKNEYVILLE O,42,534,301,0,877
Gwinnett PUCKETTS E,PUCKETTS E,104,987,377,2,1470
Gwinnett CATES I,CATES I,89,637,377,0,1103
Gwinnett CATES J,CATES J,74,668,354,0,1096
Gwinnett GOODWINS B,GOODWINS B,77,536,329,0,942
Gwinnett LAWRENCEVILLE F,LAWRENCEVILLE F,83,963,322,1,1369
Gwinnett MARTINS E,MARTINS E,107,863,527,6,1503
Gwinnett PINCKNEYVILLE P,PINCKNEYVILLE P,60,374,200,1,635
Gwinnett PINCKNEYVILLE Q,PINCKNEYVILLE Q,25,250,262,0,537
Gwinnett ROCKBRIDGE C,ROCKBRIDGE C,150,1605,498,0,2253
Gwinnett ROCKBRIDGE D,ROCKBRIDGE D,94,1086,348,0,1528
Gwinnett GOODWINS C,GOODWINS C,152,900,509,1,1562
Gwinnett BAYCREEK K,BAYCREEK K,84,781,368,0,1233
Gwinnett CATES K,CATES K,53,436,299,0,788
Gwinnett BAYCREEK C,BAYCREEK C,147,1456,688,3,2294
Gwinnett CATES L,CATES L,96,844,375,0,1315
Gwinnett DULUTH E,DULUTH E,99,994,481,2,1576
Gwinnett GOODWINS D,GOODWINS D,89,522,442,0,1053
Gwinnett LAWRENCEVILLE G,LAWRENCEVILLE G,68,493,356,1,918
Gwinnett LAWRENCEVILLE H,LAWRENCEVILLE H,100,679,312,1,1092
Gwinnett MARTINS F,MARTINS F,37,381,256,0,674
Gwinnett PINCKNEYVILLE S,PINCKNEYVILLE S,72,464,336,1,873
Gwinnett ROCKBRIDGE E,ROCKBRIDGE E,114,978,487,1,1580
Gwinnett SUGAR HILL E,SUGAR HILL E,76,553,211,2,842
Gwinnett LAWRENCEVILLE I,LAWRENCEVILLE I,69,537,319,0,925
Gwinnett BAYCREEK D,BAYCREEK D,116,924,432,4,1476
Gwinnett BERKSHIRE J,BERKSHIRE J,49,501,236,0,786
Gwinnett CATES M,CATES M,100,662,378,0,1140
Gwinnett CATES N,CATES N,52,340,193,0,585
Gwinnett DULUTH F,DULUTH F,124,1083,516,4,1727
Gwinnett DULUTH G,DULUTH G,70,451,219,0,740
Gwinnett GOODWINS E,GOODWINS E,106,829,451,1,1387
Gwinnett GOODWINS F,GOODWINS F,70,517,254,0,841
Gwinnett PINCKNEYVILLE T,PINCKNEYVILLE T,61,489,328,0,878
Gwinnett SUWANEE B,SUWANEE B,90,878,236,1,1205
Gwinnett PINCKNEYVILLE U,PINCKNEYVILLE U,43,324,256,0,623
Gwinnett PUCKETTS B,PUCKETTS B,50,359,150,0,559
Gwinnett BERKSHIRE L,BERKSHIRE L,60,442,328,2,832
Gwinnett ROCKBRIDGE F,ROCKBRIDGE F,124,1841,528,0,2493
Gwinnett SUGAR HILL F,SUGAR HILL F,67,505,336,0,908
Gwinnett SUWANEE C,SUWANEE C,130,922,382,3,1437
Gwinnett CATES O,CATES O,24,221,133,0,378
Gwinnett BAYCREEK E,BAYCREEK E,103,681,397,2,1183
Gwinnett BERKSHIRE M,BERKSHIRE M,31,327,154,1,513
Gwinnett MARTINS G,MARTINS G,35,294,261,0,590
Gwinnett DULUTH H,DULUTH H,92,480,218,0,790
Gwinnett BERKSHIRE N,BERKSHIRE N,94,683,219,0,996
Gwinnett PINCKNEYVILLE V,PINCKNEYVILLE V,25,270,145,0,440
Gwinnett PINCKNEYVILLE W,PINCKNEYVILLE W,78,668,351,0,1097
Gwinnett MARTINS H,MARTINS H,122,691,479,0,1292
Gwinnett MARTINS I,MARTINS I,72,556,360,0,988
Gwinnett MARTINS J,MARTINS J,54,579,451,0,1084
Gwinnett GARNERS F,GARNERS F,38,329,141,0,508
Gwinnett BERKSHIRE O,BERKSHIRE O,59,381,238,0,678
Gwinnett BERKSHIRE P,BERKSHIRE P,33,182,142,1,358
Gwinnett PINCKNEYVILLE X,PINCKNEYVILLE X,115,772,233,1,1121
Gwinnett ROCKBRIDGE G,ROCKBRIDGE G,154,1632,559,4,2349
Gwinnett PINCKNEYVILLE Y,PINCKNEYVILLE Y,41,428,281,1,751
Gwinnett GOODWINS G,GOODWINS G,47,389,320,0,756
Gwinnett PINCKNEYVILLE Z,PINCKNEYVILLE Z,61,272,175,0,508
Gwinnett PINCKNEYVILLE A1,PINCKNEYVILLE A1,83,469,205,0,757
Gwinnett LAWRENCEVILLE J,LAWRENCEVILLE J,57,426,254,0,737
Gwinnett GOODWINS H,GOODWINS H,58,427,274,1,760
Gwinnett DUNCANS B,DUNCANS B,95,744,398,1,1238
Gwinnett SUWANEE D,SUWANEE D,92,632,308,3,1035
Gwinnett SUWANEE E,SUWANEE E,95,713,252,2,1062
Gwinnett LAWRENCEVILLE K,LAWRENCEVILLE K,73,499,310,0,882
Gwinnett HARBINS B,HARBINS B,81,777,286,1,1145
Gwinnett BAYCREEK F,BAYCREEK F,122,1096,561,1,1780
Gwinnett PUCKETTS C,PUCKETTS C,51,415,217,0,683
Gwinnett HOG MOUNTAIN C,HOG MOUNTAIN C,91,591,277,2,961
Gwinnett ROCKYCREEK B,ROCKYCREEK B,81,722,354,1,1158
Gwinnett DULUTH I,DULUTH I,136,640,292,0,1068
Gwinnett MARTINS K,MARTINS K,109,958,607,5,1679
Gwinnett SUWANEE H,SUWANEE H,87,516,198,1,802
Gwinnett SUGAR HILL G,SUGAR HILL G,66,382,134,0,582
Gwinnett SUWANEE F,SUWANEE F,98,642,299,2,1041
Gwinnett LAWRENCEVILLE L,LAWRENCEVILLE L,119,851,496,1,1467
Gwinnett LAWRENCEVILLE M,LAWRENCEVILLE M,104,1552,655,1,2312
Gwinnett BAYCREEK G,BAYCREEK G,166,1779,817,3,2765
Gwinnett BAYCREEK H,BAYCREEK H,207,1582,685,3,2477
Gwinnett BAYCREEK I,BAYCREEK I,129,1129,502,3,1763
Gwinnett BERKSHIRE Q,BERKSHIRE Q,37,272,153,0,462
Gwinnett GOODWINS I,GOODWINS I,47,422,254,0,723
Gwinnett DULUTH K,DULUTH K,39,399,197,2,637
Gwinnett HARBINS C,HARBINS C,38,558,293,2,891
Gwinnett ROCKYCREEK C,ROCKYCREEK C,69,828,405,1,1303
Gwinnett LAWRENCEVILLE N,LAWRENCEVILLE N,35,356,205,0,596
Gwinnett PUCKETTS D,PUCKETTS D,75,495,194,3,767
Gwinnett SUWANEE G,SUWANEE G,93,633,377,2,1105
Gwinnett BAYCREEK J,BAYCREEK J,106,1058,580,0,1744
Habersham Habersham North,Habersham North,98,605,117,0,820
Habersham Habersham South,Habersham South,81,342,214,0,637
Habersham Demorest,Demorest,33,198,88,0,319
Habersham Town of Mount Airy,Town of Mount Airy,8,41,22,0,71
Habersham City of Baldwin,City of Baldwin,0,0,0,0,0
Habersham Mud Creek,Mud Creek,34,182,60,0,276
Habersham Amys Creek,Amys Creek,31,129,39,0,199
Hall Wilson,Wilson,200,425,222,0,847
Hall Chicopee,Chicopee,39,343,259,1,642
Hall Oakwood I,Oakwood I,22,219,190,1,432
Hall Oakwood II,Oakwood II,67,307,159,0,533
Hall Flowery Branch I,Flowery Branch I,66,377,184,1,628
Hall Flowery Branch II,Flowery Branch II,58,317,190,0,565
Hall Roberts,Roberts,80,402,180,0,662
Hall Morgan I,Morgan I,33,229,105,0,367
Hall Morgan II,Morgan II,72,353,220,0,645
Hall Candler,Candler,64,335,242,0,641
Hall Tadmore,Tadmore,80,461,331,0,872
Hall Glade,Glade,47,216,110,0,373
Hall Lula,Lula,28,112,75,0,215
Hall Clermont,Clermont,13,120,46,0,179
Hall Quillians,Quillians,18,109,40,0,167
Hall Bark Camp,Bark Camp,77,336,127,0,540
Hall Chestatee,Chestatee,53,194,118,0,365
Hall Fork,Fork,79,192,115,0,386
Hall Whelchel,Whelchel,49,262,135,0,446
Hall West Whelchel,West Whelchel,110,305,128,0,543
Hall Gainesville I,Gainesville I,73,343,177,3,596
Hall Gainesville II,Gainesville II,180,531,293,0,1004
Hall Gainesville III,Gainesville III,56,316,278,0,650
Hall Gainesville IV,Gainesville IV,64,311,121,0,496
Hall Gainesville V,Gainesville V,26,116,72,0,214
Hall Gillsville,Gillsville,11,27,30,0,68
Hall Big Hickory,Big Hickory,33,176,62,0,271
Hall Friendship I,Friendship I,229,757,236,0,1222
Hall Friendship II,Friendship II,38,348,147,0,533
Hall Friendship III,Friendship III,66,354,148,0,568
Hall Friendship IV,Friendship IV,51,492,86,0,629
Hancock Devereux Fire,Devereux Fire,56,146,100,0,302
Hancock St Mark,St Mark,37,118,85,0,240
Hancock Courthouse,Courthouse,50,187,116,0,353
Hancock Second Beulah,Second Beulah,59,108,70,0,237
Hancock Mayfield Community Center,Mayfield Community Center,34,52,68,0,154
Hancock Power of God,Power of God,53,139,100,0,292
Hancock Warren Chapel,Warren Chapel,21,45,13,0,79
Hancock Youth Center,Youth Center,60,230,142,0,432
Hancock Second Darrien,Second Darrien,32,59,65,1,157
Hancock Sparta 4C,Sparta 4C,15,36,16,0,67
Haralson Bremen,Bremen,63,264,178,0,505
Haralson Buchanan,Buchanan,5,73,31,0,109
Haralson Buncombe,Buncombe,3,17,27,0,47
Haralson Corinth,Corinth,6,40,19,0,65
Haralson Twentieth,Twentieth,1,13,16,0,30
Haralson Felton,Felton,3,2,3,0,8
Haralson Little Creek,Little Creek,0,12,14,0,26
Haralson Mt View,Mt View,0,3,8,0,11
Haralson Seventh,Seventh,9,76,30,0,115
Haralson Berea-Steadman,Berea-Steadman,0,16,8,0,24
Haralson Tallapoosa,Tallapoosa,14,75,83,0,172
Haralson Waco,Waco,0,21,33,0,54
Harris Cataula,Cataula,52,237,129,0,418
Harris Ellerslie,Ellerslie,78,436,231,0,745
Harris Goodman,Goodman,23,164,150,0,337
Harris Hamilton,Hamilton,58,352,132,0,542
Harris Lower 19th,Lower 19th,33,170,100,0,303
Harris Mulberry Grove,Mulberry Grove,46,191,111,0,348
Harris Pine Mountain Valley,Pine Mountain Valley,7,56,38,0,101
Harris Skinner,Skinner,20,51,141,0,212
Harris Upper 19th,Upper 19th,15,64,60,0,139
Harris Valley Plains,Valley Plains,10,34,75,0,119
Harris Waverly Hall,Waverly Hall,70,282,184,0,536
Harris Whitesville,Whitesville,25,100,83,0,208
Hart Hartwell,Hartwell,102,560,247,0,909
Hart Goldmine,Goldmine,19,72,62,0,153
Hart Cokesbury,Cokesbury,24,119,92,0,235
Hart Reed Creek,Reed Creek,35,174,96,0,305
Hart Bowersville,Bowersville,4,56,63,0,123
Hart Shoal Creek,Shoal Creek,11,63,72,0,146
Hart Bio,Bio,19,88,61,0,168
Heard Centralhatchee,Centralhatchee,22,53,43,1,119
Heard Cooksville-Corinth,Cooksville-Corinth,1,10,19,0,30
Heard Enon Grove,Enon Grove,11,23,20,0,54
Heard Ephesus,Ephesus,5,21,24,0,50
Heard Franklin,Franklin,51,114,68,0,233
Heard Southwest,Southwest,12,30,40,0,82
Henry Locust Grove,Locust Grove,144,2136,567,0,2847
Henry Tussahaw,Tussahaw,23,210,100,0,333
Henry Sandy Ridge,Sandy Ridge,35,495,210,0,740
Henry Westside,Westside,178,1299,565,5,2047
Henry Lowes,Lowes,230,2472,950,1,3653
Henry South Hampton,South Hampton,85,1151,350,1,1587
Henry North Hampton,North Hampton,143,1596,523,1,2263
Henry Mount Carmel,Mount Carmel,175,1996,629,3,2803
Henry Red Oak,Red Oak,130,1858,673,0,2661
Henry Wesley Lakes,Wesley Lakes,125,1768,671,1,2565
Henry McDonough,McDonough,63,837,286,1,1187
Henry McMullen,McMullen,71,464,197,0,732
Henry East Lake,East Lake,49,685,181,0,915
Henry Hickory Flat,Hickory Flat,118,1496,509,0,2123
Henry Stockbridge East-West,Stockbridge East-West,196,1825,613,1,2635
Henry Stagecoach,Stagecoach,66,754,257,0,1077
Henry Cotton Indian,Cotton Indian,77,1177,336,0,1590
Henry Pleasant Grove,Pleasant Grove,84,1026,284,0,1394
Henry Austin Road,Austin Road,62,1095,297,0,1454
Henry Swan Lake,Swan Lake,51,673,208,0,932
Henry Shakerag,Shakerag,98,1634,448,1,2181
Henry Ellenwood,Ellenwood,148,1770,369,0,2287
Henry Unity Grove,Unity Grove,59,715,181,1,956
Henry Shiloh,Shiloh,121,882,338,3,1344
Henry Pates Creek,Pates Creek,125,1279,415,2,1821
Henry Oakland,Oakland,111,1005,364,0,1480
Henry Lake Dow,Lake Dow,95,936,364,1,1396
Henry Flippen,Flippen,152,1469,382,0,2003
Henry Stockbridge Central,Stockbridge Central,74,965,362,0,1401
Henry Kelleytown,Kelleytown,61,644,268,0,973
Henry Lighthouse,Lighthouse,75,1025,304,1,1405
Henry Dutchtown,Dutchtown,59,529,218,0,806
Henry Mt Bethel,Mt Bethel,41,386,250,0,677
Henry Grove Park,Grove Park,59,752,309,1,1121
Henry Lake Haven,Lake Haven,78,773,269,0,1120
Henry McDonough Central,McDonough Central,87,1027,316,2,1432
Henry Timberridge,Timberridge,55,445,202,0,702
Houston ANNX,ANNX,124,592,218,1,935
Houston BMS,BMS,226,1377,495,2,2100
Houston CENT,CENT,125,1152,509,0,1786
Houston CGTC,CGTC,90,766,187,0,1043
Houston FMMS,FMMS,154,1491,656,1,2302
Houston HAFS,HAFS,30,108,82,0,220
Houston HCTC,HCTC,118,835,362,0,1315
Houston HEFS,HEFS,30,115,126,2,273
Houston HHPC,HHPC,182,1467,540,1,2190
Houston MCMS,MCMS,152,1493,422,2,2069
Houston NHSC,NHSC,48,386,101,0,535
Houston ROZR,ROZR,340,1555,686,2,2583
Houston TMS,TMS,124,961,401,0,1486
Houston TWPK,TWPK,92,602,326,0,1020
Houston VHS,VHS,110,939,338,1,1388
Houston WELL,WELL,264,1640,777,2,2683
Irwin Irwinville,Irwinville,1,40,24,0,65
Irwin Ocilla,Ocilla,47,323,191,4,565
Irwin Holt,Holt,7,32,33,0,72
Jackson Central Jackson,Central Jackson,140,1075,484,1,1700
Jackson North Jackson,North Jackson,118,603,359,0,1080
Jackson West Jackson,West Jackson,159,1049,518,1,1727
Jackson South Jackson,South Jackson,108,550,254,1,913
Jasper Wyatt,Wyatt,24,79,89,0,192
Jasper Monticello,Monticello,141,530,217,0,888
Jasper Martin & Burney,Martin & Burney,21,98,87,0,206
Jeff Davis Hazlehurst,Hazlehurst,26,171,109,0,306
Jeff Davis Altamaha 1,Altamaha 1,1,17,9,0,27
Jeff Davis Altamaha 2,Altamaha 2,1,10,7,0,18
Jeff Davis Blackburn 1,Blackburn 1,8,31,14,0,53
Jeff Davis Blackburn 2,Blackburn 2,0,7,5,0,12
Jeff Davis Whitehead 1,Whitehead 1,3,46,31,0,80
Jeff Davis Whitehead 2,Whitehead 2,5,6,7,0,18
Jeff Davis Ocmulgee 1,Ocmulgee 1,7,46,33,0,86
Jeff Davis Ocmulgee 2,Ocmulgee 2,1,40,5,0,46
Jefferson Stapleton Crossroads,Stapleton Crossroads,13,41,43,0,97
Jefferson Matthews,Matthews,13,43,49,0,105
Jefferson Wrens,Wrens,93,326,362,0,781
Jefferson Louisville,Louisville,136,713,326,0,1175
Jefferson Wadley,Wadley,103,266,270,0,639
Jefferson Bartow,Bartow,8,71,47,0,126
Jefferson Stapleton,Stapleton,11,43,81,0,135
Jefferson Avera,Avera,3,9,19,0,31
Jenkins Primary School,Primary School,16,177,92,0,285
Jenkins Court House,Court House,15,127,79,0,221
Jenkins Perkins,Perkins,10,89,29,0,128
Jenkins Senior Citizens Center,Senior Citizens Center,5,62,19,0,86
Jenkins Four Points,Four Points,16,77,58,0,151
Johnson Wrightsville,Wrightsville,78,406,177,0,661
Johnson Smith,Smith,1,22,20,0,43
Johnson Bray,Bray,17,64,39,0,120
Johnson Kite,Kite,5,20,18,0,43
Jones Gray,Gray,35,260,90,0,385
Jones Hawkins,Hawkins,151,631,291,0,1073
Jones Ethridge,Ethridge,49,188,104,0,341
Jones Clinton,Clinton,45,227,77,1,350
Jones Roberts,Roberts,31,228,189,0,448
Jones Davidson,Davidson,18,67,36,0,121
Jones Pope,Pope,39,170,118,0,327
Jones Barron,Barron,39,106,51,0,196
Jones Sanders,Sanders,0,5,11,0,16
Jones Finney,Finney,57,194,149,0,400
Lamar Barnesville,Barnesville,106,409,199,0,714
Lamar Chappell Mill V. FD,Chappell Mill V. FD,24,83,55,0,162
Lamar Senior Citzen Bldg,Senior Citzen Bldg,22,151,72,0,245
Lamar Redbone,Redbone,10,26,22,0,58
Lamar L C S C,L C S C,54,195,94,0,343
Lamar Milner,Milner,53,244,144,0,441
Lanier Lakeland,Lakeland,36,415,240,0,691
Laurens FBC-FLC,FBC-FLC,94,478,276,0,848
Laurens Calhoun Park,Calhoun Park,240,891,608,0,1739
Laurens Fire Dept Station 5,Fire Dept Station 5,70,375,168,1,614
Laurens Buckeye,Buckeye,29,119,107,0,255
Laurens Burch,Burch,11,20,19,0,50
Laurens Cadwell,Cadwell,4,21,33,0,58
Laurens Brewton,Brewton,18,73,89,0,180
Laurens Dudley,Dudley,24,106,99,0,229
Laurens Hampton Mill,Hampton Mill,9,42,70,0,121
Laurens Minter,Minter,0,14,25,0,39
Laurens Rural Fire Station 7,Rural Fire Station 7,32,134,114,0,280
Laurens WT Adams Fire Station 18,WT Adams Fire Station 18,65,204,122,0,391
Laurens Reedy Springs,Reedy Springs,11,22,41,0,74
Laurens Smith,Smith,71,314,303,0,688
Laurens LCFS #10,LCFS #10,52,193,161,1,407
Lee Chokee,Chokee,24,53,53,0,130
Lee Redbone,Redbone,30,305,193,1,529
Lee Smithville ,Smithville ,19,74,123,0,216
Lee CJC,CJC,4,30,14,0,48
Lee Leesburg,Leesburg,38,272,172,1,483
Lee Friendship Baptist,Friendship Baptist,6,105,30,0,141
Lee First Baptist,First Baptist,62,433,279,0,774
Lee SDA Church,SDA Church,14,152,99,1,266
Lee Flint Reformed Baptist ,Flint Reformed Baptist ,19,166,131,0,316
Lee Century Fire Station,Century Fire Station,25,267,217,1,510
Liberty Riceboro,Riceboro,66,303,139,1,509
Liberty Lyman Hall,Lyman Hall,117,848,296,0,1261
Liberty Lewis Frasier,Lewis Frasier,59,476,161,0,696
Liberty Memorial Dr,Memorial Dr,65,381,124,0,570
Liberty Performing Arts CTR,Performing Arts CTR,56,403,163,0,622
Liberty Town of Allenhurst,Town of Allenhurst,53,379,144,0,576
Liberty Hinesville,Hinesville,67,528,227,0,822
Liberty Liberty County Complex,Liberty County Complex,164,882,197,1,1244
Liberty Victory Baptist,Victory Baptist,76,828,264,1,1169
Liberty Fleming East,Fleming East,48,238,123,1,410
Liberty Gum Branch,Gum Branch,63,398,147,0,608
Liberty Progressive Church,Progressive Church,73,519,156,0,748
Lincoln Midway,Midway,19,33,38,0,90
Lincoln Lincoln Club House,Lincoln Club House,48,127,102,0,277
Lincoln Lincoln Center,Lincoln Center,37,91,59,0,187
Lincoln Faith Temple of Lincoln,Faith Temple of Lincoln,15,39,36,0,90
Lincoln Tabernacle,Tabernacle,33,96,65,0,194
Lincoln Bethany Church,Bethany Church,3,26,11,0,40
Lincoln Martins Crossroad,Martins Crossroad,16,72,26,0,114
Long Breads Creek,Breads Creek,21,123,98,0,242
Long Rye Patch_Oak Dale,Rye Patch_Oak Dale,19,181,128,0,328
Long South Ludowici,South Ludowici,16,224,97,0,337
Long North Ludowici,North Ludowici,6,242,101,1,350
Long Tibet,Tibet,2,43,23,0,68
Long Alma Flournoy,Alma Flournoy,0,1,1,0,2
Long Faith Baptist Annex,Faith Baptist Annex,4,75,37,0,116
Lowndes Train Depot,Train Depot,25,196,129,0,350
Lowndes Historical Society ,Historical Society ,7,97,47,0,151
Lowndes Hahira Community Center ,Hahira Community Center ,5,70,44,1,120
Lowndes Pine Grove Church,Pine Grove Church,24,218,69,0,311
Lowndes Trinity Church,Trinity Church,56,504,201,1,762
Lowndes Nazarene Church,Nazarene Church,70,758,259,2,1089
Lowndes Mathis Auditorium ,Mathis Auditorium ,172,1366,442,1,1981
Lowndes Jaycee Community Center,Jaycee Community Center,40,434,126,3,603
Lowndes Lowndes Civic,Lowndes Civic,146,1611,531,25,2313
Lowndes Naylor Community Center,Naylor Community Center,13,153,96,0,262
Lowndes Rainwater,Rainwater,223,1959,670,12,2864
Lowndes VSU,VSU,1,17,30,0,48
Lowndes Mt. Calvary Church,Mt. Calvary Church,42,321,126,3,492
Lowndes Mildred Community Center,Mildred Community Center,96,477,286,1,860
Lowndes Paper Mill Union,Paper Mill Union,33,183,120,2,338
Lowndes Dasher City Hall,Dasher City Hall,17,119,67,0,203
Lowndes Lake Park,Lake Park,42,188,123,2,355
Lowndes South Lowndes Recreation Center,South Lowndes Recreation Center,24,98,51,0,173
Lumpkin Dahlonega,Dahlonega,230,1424,416,0,2070
Macon Ideal,Ideal,27,206,94,0,327
Macon Oglethorpe,Oglethorpe,34,278,83,0,395
Macon Marshallville,Marshallville,34,148,254,0,436
Macon Montezuma #4,Montezuma #4,45,306,175,0,526
Macon Montezuma #5,Montezuma #5,55,289,181,0,525
Madison Colbert,Colbert,44,269,194,0,507
Madison Collins,Collins,0,22,18,0,40
Madison Comer,Comer,62,111,121,0,294
Madison Danielsville,Danielsville,21,180,58,0,259
Madison Fork,Fork,18,36,45,0,99
Madison Harrison,Harrison,2,5,11,0,18
Madison Hull,Hull,56,391,340,1,788
Madison Ila,Ila,18,61,32,0,111
Madison Mill,Mill,14,49,33,0,96
Madison Paoli,Paoli,2,6,6,0,14
Madison Pittman,Pittman,27,94,78,0,199
Madison Poca,Poca,10,34,31,0,75
Marion Pineknot,Pineknot,4,19,13,0,36
Marion Buena Vista,Buena Vista,135,463,198,0,796
Marion Tazewell,Tazewell,3,15,15,0,33
Marion Brantley,Brantley,7,8,10,0,25
Marion Fort Perry,Fort Perry,1,37,26,0,64
McDuffie NMcDuffie,NMcDuffie,2,41,18,0,61
McDuffie Cedar Rock,Cedar Rock,235,860,352,0,1447
McDuffie Depot,Depot,105,288,184,0,577
McDuffie Sweetwater,Sweetwater,11,99,45,0,155
McDuffie White Oak,White Oak,39,212,75,0,326
McDuffie Dearing,Dearing,34,135,51,0,220
McDuffie Fort Creek,Fort Creek,31,124,37,0,192
McIntosh Sapelo Island,Sapelo Island,3,4,18,0,25
McIntosh Crescent,Crescent,74,407,237,1,719
McIntosh Darien,Darien,58,288,95,0,441
McIntosh South Newport,South Newport,54,228,74,0,356
McIntosh North Darien,North Darien,33,238,111,0,382
Meriwether Chalybeate,Chalybeate,12,15,14,0,41
Meriwether Gill I,Gill I,30,107,155,0,292
Meriwether Gill II,Gill II,57,148,197,0,402
Meriwether 7th-Odessadale,7th-Odessadale,15,25,39,0,79
Meriwether 8th-Greenville,8th-Greenville,60,308,125,0,493
Meriwether Lone Oak,Lone Oak,46,152,121,0,319
Meriwether Luthersville,Luthersville,55,230,201,0,486
Meriwether Upper 9th-Alvaton,Upper 9th-Alvaton,27,90,147,0,264
Meriwether Middle 9th-Gay,Middle 9th-Gay,8,20,22,0,50
Meriwether Lower 9th-Woodbury,Lower 9th-Woodbury,21,110,211,0,342
Meriwether 2nd-Warm Springs,2nd-Warm Springs,13,78,115,0,206
Meriwether Third-Durand,Third-Durand,15,54,55,1,125
Meriwether Raleigh,Raleigh,9,28,15,0,52
Meriwether Cove,Cove,0,2,7,0,9
Miller Colquitt-Miller,Colquitt-Miller,48,223,191,0,462
Mitchell Baconton,Baconton,23,113,116,0,252
Mitchell Branchville,Branchville,7,29,16,0,52
Mitchell Camilla North,Camilla North,124,352,263,0,739
Mitchell Camilla South,Camilla South,125,527,247,0,899
Mitchell Cotton,Cotton,0,4,5,0,9
Mitchell Hopeful,Hopeful,4,12,10,0,26
Mitchell Hinsonton,Hinsonton,2,4,3,0,9
Mitchell Lester,Lester,16,63,27,0,106
Mitchell Pebble City,Pebble City,0,4,7,0,11
Mitchell Pelham,Pelham,76,349,262,0,687
Mitchell Sale City,Sale City,4,6,29,0,39
Monroe Bentons,Bentons,33,193,79,0,305
Monroe Brantleys,Brantleys,7,49,38,0,94
Monroe Burgays,Burgays,20,160,82,0,262
Monroe Cabaniss,Cabaniss,10,64,40,1,115
Monroe Cox,Cox,16,49,29,0,94
Monroe Culloden,Culloden,9,21,58,0,88
Monroe Dillards,Dillards,6,58,32,0,96
Monroe Evers,Evers,24,159,80,0,263
Monroe Forsyth,Forsyth,187,810,329,0,1326
Monroe High Falls,High Falls,13,102,39,0,154
Monroe Kelseys,Kelseys,23,108,68,0,199
Monroe Middlebrooks,Middlebrooks,3,73,35,0,111
Monroe Proctors,Proctors,11,74,80,0,165
Monroe Russellville,Russellville,2,16,25,0,43
Montgomery Ailey,Ailey,7,37,35,0,79
Montgomery Alston,Alston,6,9,12,0,27
Montgomery Higgston,Higgston,10,80,58,0,148
Montgomery Kibbee,Kibbee,0,9,11,0,20
Montgomery Mount Vernon,Mount Vernon,17,143,108,0,268
Montgomery Tarrytown,Tarrytown,1,2,6,0,9
Montgomery Uvalda,Uvalda,8,71,40,0,119
Morgan Rec Dept,Rec Dept,93,621,241,1,956
Morgan Centennial,Centennial,17,183,107,0,307
Morgan Gibbs,Gibbs,27,257,112,0,396
Morgan DFACS,DFACS,58,265,84,0,407
Morgan Buckhead,Buckhead,48,240,119,0,407
Murray McDonald,McDonald,11,61,48,0,120
Murray Shuck Pen,Shuck Pen,8,49,95,0,152
Murray Southwest,Southwest,8,47,64,0,119
Murray Spring Place,Spring Place,19,92,116,0,227
Murray Town,Town,32,202,131,0,365
Murray Carters-Doolittle,Carters-Doolittle,9,38,35,0,82
Murray North,North,9,39,47,0,95
Muscogee Wynnton,Wynnton,203,953,522,0,1678
Muscogee Carver/Library,Carver/Library,237,985,282,0,1504
Muscogee Shirley Winston,Shirley Winston,302,1693,395,0,2390
Muscogee Britt David,Britt David,49,236,174,0,459
Muscogee St Peter,St Peter,54,337,244,0,635
Muscogee Chattahoochee,Chattahoochee,107,804,405,1,1317
Muscogee Columbus Tech,Columbus Tech,75,361,201,1,638
Muscogee Central,Central,140,745,283,1,1169
Muscogee Wynnbrook,Wynnbrook,89,279,88,1,457
Muscogee Cusseta Rd,Cusseta Rd,222,951,543,1,1717
Muscogee OLOLC,OLOLC,338,1197,740,2,2277
Muscogee Mt Pilgrim,Mt Pilgrim,298,1743,601,4,2646
Muscogee Faith Tabernacle,Faith Tabernacle,221,1234,435,1,1891
Muscogee Canaan,Canaan,291,1498,517,0,2306
Muscogee Holsey,Holsey,267,1958,573,1,2799
Muscogee Gentian,Gentian,111,895,290,0,1296
Muscogee St Paul,St Paul,112,744,333,0,1189
Muscogee Moon,Moon,104,539,332,0,975
Muscogee St Andrews,St Andrews,198,1132,517,1,1848
Muscogee Salvation Army,Salvation Army,52,499,272,2,825
Muscogee First African,First African,49,222,160,0,431
Muscogee Epworth,Epworth,64,415,284,0,763
Muscogee Gallops,Gallops,73,389,233,1,696
Muscogee Edgewood,Edgewood,108,688,229,1,1026
Muscogee Psalmond,Psalmond,192,1501,524,0,2217
Newton 01-City Pond,01-City Pond,84,200,171,0,455
Newton 02-Town,02-Town,253,765,390,0,1408
Newton 03-Almon,03-Almon,178,1297,614,0,2089
Newton 04-Alcovy,04-Alcovy,101,807,391,1,1300
Newton 05-Covington Mills,05-Covington Mills,97,473,325,0,895
Newton 06-Brewers,06-Brewers,92,280,231,0,603
Newton 07-Brick Store,07-Brick Store,49,260,169,0,478
Newton 08-Cedar Shoals,08-Cedar Shoals,88,508,288,0,884
Newton 09-Livingston,09-Livingston,163,1107,492,0,1762
Newton 10-Downs,10-Downs,153,1372,498,0,2023
Newton 12-Gum Creek,12-Gum Creek,86,536,182,0,804
Newton 13-Beaverdam,13-Beaverdam,175,1333,706,1,2215
Newton 14-Leguinn,14-Leguinn,47,175,129,0,351
Newton 15-Mansfield,15-Mansfield,23,55,52,0,130
Newton 16-Newborn,16-Newborn,4,26,58,0,88
Newton 17-Oxford,17-Oxford,52,185,183,0,420
Newton 18-Rocky Plains,18-Rocky Plains,76,464,312,0,852
Newton 19-Buck Creek,19-Buck Creek,130,934,355,0,1419
Newton 20-Stansells,20-Stansells,161,1207,616,3,1987
Newton 23-Fairview,23-Fairview,92,646,381,0,1119
Newton 24-Crowell,24-Crowell,172,1209,581,0,1962
Newton 25-Hub,25-Hub,21,138,128,0,287
Oconee City Hall,City Hall,89,661,204,0,954
Oconee Colham Ferry,Colham Ferry,57,422,103,0,582
Oconee Bishop,Bishop,49,349,119,0,517
Oconee North Oconee,North Oconee,26,292,116,0,434
Oconee Dark Corner,Dark Corner,44,314,131,0,489
Oconee Bogart,Bogart,26,211,161,0,398
Oconee Marswood Hall,Marswood Hall,95,532,192,1,820
Oconee Civic Center,Civic Center,206,1067,316,0,1589
Oglethorpe Beaverdam,Beaverdam,50,303,219,0,572
Oglethorpe Crawford,Crawford,66,292,144,0,502
Oglethorpe Lexington,Lexington,93,430,168,1,692
Paulding Burnt Hickory Park,Burnt Hickory Park,58,413,213,0,684
Paulding Crossroads Library,Crossroads Library,67,383,218,0,668
Paulding Shelton Elementary,Shelton Elementary,116,768,394,4,1282
Paulding Russom Elementary,Russom Elementary,273,1238,629,0,2140
Paulding Paulding Sr Center,Paulding Sr Center,115,822,380,0,1317
Paulding Legacy Bapt Church,Legacy Bapt Church,91,573,284,0,948
Paulding Watson Govt Cmplx,Watson Govt Cmplx,195,1248,598,2,2043
Paulding East Paulding Middle Sch,East Paulding Middle Sch,218,1367,612,3,2200
Paulding Events Place,Events Place,154,1094,452,5,1705
Paulding Poplar Sprgs Bapt Church,Poplar Sprgs Bapt Church,100,831,386,4,1321
Paulding D Wright Innovation Ctr,D Wright Innovation Ctr,110,983,357,3,1453
Paulding Taylor Farm Park,Taylor Farm Park,32,322,181,1,536
Paulding Nebo Elem School,Nebo Elem School,129,832,422,1,1384
Paulding White Oak Park,White Oak Park,100,617,351,1,1069
Paulding Mulberry Rock Park,Mulberry Rock Park,58,413,207,0,678
Paulding Beulahland Baptist Church,Beulahland Baptist Church,21,141,77,0,239
Paulding Paulding County Airport,Paulding County Airport,53,263,166,0,482
Paulding Dobbins Middle School,Dobbins Middle School,192,1498,588,0,2278
Peach Byron #1,Byron #1,19,303,111,3,436
Peach Byron #2,Byron #2,88,759,245,1,1093
Peach Claude,Claude,9,49,26,0,84
Peach Fort Valley #1,Fort Valley #1,67,492,234,0,793
Peach Fort Valley #2,Fort Valley #2,56,486,227,0,769
Peach Fort Valley #3,Fort Valley #3,118,691,220,2,1031
Peach Powersville,Powersville,18,148,59,0,225
Pickens Yellow Creek,Yellow Creek,56,273,96,0,425
Pickens Sharptop,Sharptop,60,230,82,0,372
Pickens Appalachian,Appalachian,23,100,42,0,165
Pickens Refuge,Refuge,17,102,43,0,162
Pickens Hill City,Hill City,14,99,48,0,161
Pickens Hinton,Hinton,5,13,23,0,41
Pickens Jerusalem,Jerusalem,9,23,30,0,62
Pickens Ludville,Ludville,2,10,17,0,29
Pickens Nelson,Nelson,7,58,46,0,111
Pickens Talking Rock,Talking Rock,15,56,24,0,95
Pickens Jasper,Jasper,26,163,74,0,263
Pickens Tate,Tate,21,86,48,0,155
Pierce Hacklebarney/Cason ,Hacklebarney/Cason ,39,207,62,0,308
Pierce Blackshear,Blackshear,9,88,24,0,121
Pierce St. Johns/Blackshear,St. Johns/Blackshear,1,37,16,0,54
Pierce Otter Creek,Otter Creek,4,41,12,0,57
Pierce Patterson,Patterson,11,39,28,0,78
Pierce Mershon,Mershon,1,9,3,0,13
Pierce Alabaha,Alabaha,5,26,6,0,37
Pierce Sunset/Sweat,Sunset/Sweat,0,5,1,0,6
Pike Concord,Concord,26,74,62,0,162
Pike Hollonville,Hollonville,18,58,22,0,98
Pike Meansville,Meansville,14,38,31,0,83
Pike Molena,Molena,8,65,60,0,133
Pike Second District,Second District,21,107,39,0,167
Pike Lifsey Springs,Lifsey Springs,15,34,26,0,75
Pike Williamson,Williamson,4,61,40,0,105
Pike Zebulon,Zebulon,49,154,49,0,252
Polk Aragon,Aragon,14,156,86,0,256
Polk Blooming Grove,Blooming Grove,9,79,34,0,122
Polk Cedartown,Cedartown,96,549,208,1,854
Polk Fish Creek,Fish Creek,21,121,47,0,189
Polk Lake Creek,Lake Creek,12,124,67,0,203
Polk Rockmart,Rockmart,58,442,197,0,697
Polk Youngs Grove,Youngs Grove,15,55,34,2,106
Pulaski Annex,Annex,115,549,240,1,905
Putnam 101,101,92,451,211,0,754
Putnam 104,104,107,528,206,0,841
Putnam 105,105,68,216,92,0,376
Putnam 106,106,15,54,35,0,104
Putnam 107,107,58,247,117,0,422
Quitman Georgetown,Georgetown,32,173,120,0,325
Quitman Morris,Morris,1,5,19,0,25
Rabun Rabun County,Rabun County,190,983,242,0,1415
Randolph Coleman,Coleman,2,15,36,0,53
Randolph Shellman,Shellman,60,64,140,0,264
Randolph Benevolence,Benevolence,3,16,33,0,52
Randolph Cuthbert-Courthouse,Cuthbert-Courthouse,103,402,163,0,668
Randolph Cuthbert,Cuthbert,16,98,57,0,171
Randolph Springvale,Springvale,5,68,36,0,109
Richmond 101,101,35,140,173,0,348
Richmond 102,102,49,115,113,0,277
Richmond 103,103,66,227,206,0,499
Richmond 104,104,124,453,459,0,1036
Richmond 105,105,39,175,153,0,367
Richmond 106,106,28,78,120,1,227
Richmond 107,107,66,231,212,0,509
Richmond 108,108,26,120,78,0,224
Richmond 109,109,12,80,67,0,159
Richmond 110,110,45,190,266,0,501
Richmond 111,111,41,211,198,0,450
Richmond 112,112,56,235,139,0,430
Richmond 115,115,13,30,52,0,95
Richmond 201,201,48,322,266,1,637
Richmond 202,202,82,628,489,4,1203
Richmond 203,203,26,135,192,2,355
Richmond 204,204,37,183,209,0,429
Richmond 207,207,84,370,319,1,774
Richmond 208,208,62,387,329,2,780
Richmond 210,210,74,346,175,0,595
Richmond 301,301,39,198,151,0,388
Richmond 302,302,13,100,122,0,235
Richmond 303,303,19,132,81,0,232
Richmond 304,304,12,80,57,0,149
Richmond 306,306,100,645,410,3,1158
Richmond 307,307,44,157,129,0,330
Richmond 308,308,5,71,57,0,133
Richmond 310,310,186,1344,785,1,2316
Richmond 401,401,74,352,215,0,641
Richmond 402,402,105,413,436,1,955
Richmond 403,403,91,559,249,0,899
Richmond 405,405,231,1890,698,2,2821
Richmond 406,406,161,1090,414,1,1666
Richmond 501,501,136,790,414,0,1340
Richmond 502,502,95,529,392,0,1016
Richmond 503,503,70,472,208,0,750
Richmond 504,504,89,410,281,1,781
Richmond 505,505,71,426,154,0,651
Richmond 506,506,116,1012,516,0,1644
Richmond 507,507,24,154,150,0,328
Richmond 601,601,94,680,359,2,1135
Richmond 602,602,17,132,98,0,247
Richmond 604,604,29,225,221,2,477
Richmond 605,605,114,594,433,1,1142
Richmond 606,606,65,407,244,1,717
Richmond 607,607,162,1194,606,3,1965
Richmond 608,608,2,5,13,0,20
Richmond 701,701,56,269,199,0,524
Richmond 702,702,21,117,148,0,286
Richmond 703,703,61,435,385,0,881
Richmond 704,704,2,46,19,0,67
Richmond 705,705,41,311,172,0,524
Richmond 706,706,53,505,194,0,752
Richmond 707,707,51,370,288,0,709
Richmond 708,708,3,34,44,0,81
Richmond 709,709,13,89,68,1,171
Richmond 801,801,3,4,8,0,15
Richmond 801B,801B,3,22,41,0,66
Richmond 802,802,52,223,249,0,524
Richmond 803,803,2,11,8,0,21
Richmond 804,804,41,349,151,1,542
Richmond 804H,804H,71,409,265,0,745
Richmond 805,805,7,147,143,0,297
Richmond 806,806,24,278,238,1,541
Richmond 807,807,36,282,185,0,503
Richmond 808,808,48,363,244,0,655
Richmond 810,810,8,84,35,0,127
Richmond 811,811,7,31,30,0,68
Rockdale BA,BA,111,1242,455,1,1809
Rockdale BT,BT,67,523,231,0,821
Rockdale CO,CO,89,851,339,1,1280
Rockdale FI,FI,193,2005,595,3,2796
Rockdale FS,FS,143,1228,342,4,1717
Rockdale HC,HC,47,506,241,0,794
Rockdale HI,HI,97,915,318,2,1332
Rockdale LA,LA,59,417,181,1,658
Rockdale LO,LO,94,1063,348,2,1507
Rockdale MA,MA,82,636,271,1,990
Rockdale MI,MI,103,1105,389,1,1598
Rockdale OT,OT,187,1578,619,4,2388
Rockdale RO,RO,134,1472,396,0,2002
Rockdale SM,SM,105,1335,373,2,1815
Rockdale SP,SP,138,1490,451,1,2080
Rockdale ST,ST,68,894,206,1,1169
Schley Precinct One,Precinct One,47,209,83,0,339
Screven Sylvania,Sylvania,32,173,70,0,275
Screven Hunters,Hunters,7,42,27,0,76
Screven Newington,Newington,12,92,86,0,190
Screven Jenk Hill Fire Sta,Jenk Hill Fire Sta,26,190,86,0,302
Screven Rocky Ford,Rocky Ford,6,42,24,0,72
Screven Bay Branch,Bay Branch,1,44,17,0,62
Screven Hiltonia,Hiltonia,13,112,78,0,203
Screven Screven Rec Dept,Screven Rec Dept,5,65,36,0,106
Screven Greenhill Church,Greenhill Church,7,47,24,0,78
Screven Sr Citizens Center,Sr Citizens Center,26,200,142,0,368
Screven Jackson Fire Station,Jackson Fire Station,7,29,13,0,49
Screven Cooperville Fire Station,Cooperville Fire Station,7,49,35,0,91
Seminole Precinct 1,Precinct 1,5,58,53,0,116
Seminole Precinct 2,Precinct 2,11,100,70,0,181
Seminole Precinct 3,Precinct 3,21,153,145,0,319
Seminole Precinct 4,Precinct 4,7,43,46,0,96
Seminole Precinct 5,Precinct 5,7,29,25,0,61
Spalding 01,01,64,237,258,1,560
Spalding 02,02,77,306,233,0,616
Spalding 03,03,52,263,108,0,423
Spalding 05,05,70,536,335,1,942
Spalding 06,06,81,355,212,1,649
Spalding 07,07,29,147,96,0,272
Spalding 08,08,27,152,110,1,290
Spalding 09,09,10,76,44,0,130
Spalding 10,10,17,254,138,1,410
Spalding 11,11,31,308,143,1,483
Spalding 12,12,24,119,58,0,201
Spalding 13,13,19,100,69,0,188
Spalding 14,14,18,108,132,0,258
Spalding 16,16,141,808,438,0,1387
Spalding 17,17,21,166,114,0,301
Spalding 19,19,33,242,177,1,453
Spalding 20,20,15,107,59,1,182
Spalding 21,21,216,996,188,1,1401
Stephens Senior Center,Senior Center,172,971,357,1,1501
Stewart Richland,Richland,79,135,169,2,385
Stewart Louvale,Louvale,13,28,59,0,100
Stewart Lumpkin,Lumpkin,43,236,79,0,358
Stewart Omaha,Omaha,6,7,39,0,52
Sumter Agri-Center,Agri-Center,80,287,76,1,444
Sumter Airport,Airport,45,299,115,1,460
Sumter Andersonville,Andersonville,10,27,22,0,59
Sumter Browns Mill,Browns Mill,21,122,56,0,199
Sumter Concord,Concord,3,19,0,0,22
Sumter JROTC,JROTC,65,420,179,0,664
Sumter Leslie,Leslie,64,176,105,0,345
Sumter Plains,Plains,28,117,135,0,280
Sumter Rec Dept,Rec Dept,153,671,242,1,1067
Sumter Rees Park,Rees Park,142,565,253,0,960
Sumter Thompson,Thompson,17,76,57,0,150
Talbot ONeal,ONeal,17,77,52,0,146
Talbot Valley,Valley,18,99,102,0,219
Talbot Junction City,Junction City,28,42,74,0,144
Talbot Geneva,Geneva,25,62,83,0,170
Talbot Talbotton,Talbotton,60,197,191,0,448
Talbot Box Springs,Box Springs,15,30,57,0,102
Talbot Flint Hill,Flint Hill,61,158,180,0,399
Taliaferro Sharon,Sharon,16,23,47,0,86
Taliaferro Crawfordville,Crawfordville,79,209,102,1,391
Tattnall Cobbtown,Cobbtown,9,26,26,0,61
Tattnall Collins,Collins,14,99,50,0,163
Tattnall District II,District II,22,250,87,0,359
Tattnall District IV,District IV,41,187,128,0,356
Tattnall District V,District V,2,31,14,0,47
Tattnall East Glennville,East Glennville,29,112,76,0,217
Tattnall Manassas,Manassas,3,29,25,0,57
Tattnall Shiloh,Shiloh,6,65,28,0,99
Taylor Precinct 1,Precinct 1,46,240,156,6,448
Taylor Precinct 5,Precinct 5,19,112,46,0,177
Taylor Precinct 6,Precinct 6,93,186,164,1,444
Telfair Helena,Helena,6,72,68,0,146
Telfair Jacksonville,Jacksonville,10,19,43,0,72
Telfair Lumber-City,Lumber-City,14,47,110,0,171
Telfair McRae,McRae,84,261,144,0,489
Telfair Milan,Milan,4,22,19,0,45
Telfair Scotland,Scotland,4,13,20,0,37
Terrell Dawson ,Dawson ,156,602,350,0,1108
Terrell Sasser,Sasser,18,130,87,0,235
Terrell Bronwood,Bronwood,25,112,88,0,225
Terrell Parrott,Parrott,18,28,49,0,95
Terrell Graves,Graves,22,48,37,0,107
Terrell Herod-Dover,Herod-Dover,11,27,32,0,70
Thomas Barwick,Barwick,5,22,39,0,66
Thomas Boston,Boston,36,208,131,1,376
Thomas Central,Central,52,407,139,0,598
Thomas Coolidge,Coolidge,12,43,50,0,105
Thomas Douglass,Douglass,47,516,291,0,854
Thomas Little Ochlocknee Baptist,Little Ochlocknee Baptist,5,83,37,0,125
Thomas Fire Station #2,Fire Station #2,30,131,42,0,203
Thomas Gatlin Creek,Gatlin Creek,25,179,78,0,282
Thomas Harper,Harper,67,458,219,0,744
Thomas Jerger,Jerger,40,255,83,0,378
Thomas Meigs,Meigs,6,45,116,0,167
Thomas Merrillville,Merrillville,9,75,24,0,108
Thomas Metcalfe,Metcalfe,5,19,23,0,47
Thomas New Covenant,New Covenant,17,188,55,0,260
Thomas Ochlocknee,Ochlocknee,3,51,41,0,95
Thomas Pavo,Pavo,1,22,14,0,37
Thomas Patten,Patten,10,32,23,0,65
Thomas Remington Esc,Remington Esc,26,299,120,1,446
Thomas Resource Center,Resource Center,67,398,166,0,631
Thomas Scott,Scott,41,383,127,0,551
Tift Tifton NE,Tifton NE,45,264,140,0,449
Tift Brighton,Brighton,23,140,49,0,212
Tift Brookfield ,Brookfield ,4,49,36,0,89
Tift Chula,Chula,6,60,29,0,95
Tift Docia,Docia,1,30,18,0,49
Tift Eldorado,Eldorado,4,23,30,0,57
Tift Omega,Omega,2,20,43,0,65
Tift TY TY,TY TY,4,61,72,0,137
Tift Tifton NW,Tifton NW,35,307,140,1,483
Tift Tifton South,Tifton South,62,331,182,1,576
Tift Mott-Litman Gym,Mott-Litman Gym,71,511,273,0,855
Tift Tifton Lodge ,Tifton Lodge ,45,301,133,0,479
Toombs 15361 Lyons,15361 Lyons,52,212,105,0,369
Toombs 39 Newbranch,39 Newbranch,22,32,18,0,72
Toombs 43 Cedar Crossing,43 Cedar Crossing,2,16,11,0,29
Toombs 513 VPD,513 VPD,99,485,254,0,838
Toombs 514 STIALC,514 STIALC,89,338,185,0,612
Towns Young Harris,Young Harris,51,266,53,1,371
Towns Hiawassee,Hiawassee,129,481,71,0,681
Treutlen Annex,Annex,9,73,20,0,102
Treutlen Soperton,Soperton,67,353,153,2,575
Troup Hollis Hand,Hollis Hand,48,254,133,0,435
Troup Administration Bldg,Administration Bldg,122,466,352,0,940
Troup Hammett Rd,Hammett Rd,90,616,502,2,1210
Troup Griggs Center,Griggs Center,102,386,337,3,828
Troup West Point,West Point,72,126,364,2,564
Troup Hogansville,Hogansville,57,244,345,0,646
Troup East Vernon,East Vernon,23,182,130,0,335
Troup Rosemont,Rosemont,37,264,127,0,428
Troup McClendon,McClendon,39,284,171,0,494
Troup Long Cane,Long Cane,41,241,163,0,445
Troup Gardner Newman,Gardner Newman,50,365,224,1,640
Troup Gray Hill,Gray Hill,13,118,131,0,262
Troup Highland,Highland,41,283,144,1,469
Troup Northside,Northside,43,319,204,0,566
Turner Ashburn,Ashburn,50,548,266,1,865
Turner Sycamore,Sycamore,4,105,58,1,168
Turner Rebecca,Rebecca,4,27,19,0,50
Twiggs Dry Branch,Dry Branch,10,57,58,0,125
Twiggs Golden Isles,Golden Isles,103,208,237,5,553
Twiggs Higgsville,Higgsville,5,55,47,0,107
Twiggs Jeffersonville-Ware,Jeffersonville-Ware,103,256,169,0,528
Twiggs Shady Grove-Tarvers,Shady Grove-Tarvers,55,95,79,0,229
Union Blairsville,Blairsville,42,190,36,0,268
Union Coosa,Coosa,29,109,37,0,175
Union Choestoe,Choestoe,25,100,32,0,157
Union Jones Creek,Jones Creek,34,135,45,0,214
Union Owltown,Owltown,20,133,33,0,186
Union Ivy Log,Ivy Log,26,125,41,0,192
Union Suches,Suches,9,32,22,0,63
Union Trackrock,Trackrock,29,78,30,0,137
Union Dooley,Dooley,17,123,59,0,199
Union Gumlog,Gumlog,29,135,35,0,199
Union Pat Colwell,Pat Colwell,27,204,49,0,280
Upson Yatesville,Yatesville,20,92,79,0,191
Upson Salem,Salem,19,98,106,0,223
Upson Redbone,Redbone,112,577,207,0,896
Upson Town,Town,208,1017,433,1,1659
Walker La Fayette,La Fayette,57,248,190,0,495
Walker Walnut Grove,Walnut Grove,9,53,36,0,98
Walker Rock Spring,Rock Spring,42,244,125,0,411
Walker Armuchee Valley,Armuchee Valley,10,36,56,0,102
Walker Mountain,Mountain,12,53,57,0,122
Walker Chattanooga Valley,Chattanooga Valley,90,275,259,0,624
Walker Kensington,Kensington,13,62,46,0,121
Walker Rossville,Rossville,65,287,235,0,587
Walker Chickamauga,Chickamauga,57,258,169,0,484
Walker Fairyland,Fairyland,13,109,100,0,222
Walker Fairview,Fairview,25,112,102,0,239
Walton Bold Springs,Bold Springs,37,344,168,0,549
Walton Whatley,Whatley,17,52,48,0,117
Walton Walker Park,Walker Park,41,199,118,0,358
Walton Gratis,Gratis,19,36,40,0,95
Walton Between,Between,43,367,152,2,564
Walton Walnut Grove,Walnut Grove,42,154,81,0,277
Walton Loganvile North,Loganvile North,40,498,237,0,775
Walton Social Circle,Social Circle,66,438,202,0,706
Walton South Monroe,South Monroe,49,310,174,0,533
Walton North Monroe,North Monroe,101,619,375,1,1096
Walton Loganville South,Loganville South,50,329,195,0,574
Walton West Walton,West Walton,41,307,206,0,554
Walton Broken Arrow,Broken Arrow,41,255,114,0,410
Walton Bay Creek,Bay Creek,33,232,99,0,364
Walton E Monroe,E Monroe,36,359,263,2,660
Walton W Monroe,W Monroe,17,148,69,0,234
Walton Tara,Tara,53,786,278,0,1117
Walton Mountain,Mountain,15,79,64,0,158
Walton Jersey,Jersey,10,56,52,0,118
Walton Blasingame,Blasingame,16,38,24,0,78
Walton Good Hope,Good Hope,24,134,78,0,236
Ware 100 - City Auditorium,100 - City Auditorium,198,994,270,0,1462
Ware 200A - Memorial Stadium,200A - Memorial Stadium,57,370,113,0,540
Ware 200B - City Auditorium,200B - City Auditorium,20,90,37,0,147
Ware 300 - Ware BoE Transportation,300 - Ware BoE Transportation,52,240,101,0,393
Ware 304 - Ware BoE Learning Center,304 - Ware BoE Learning Center,3,21,17,0,41
Ware 400 - Second Baptist Church,400 - Second Baptist Church,8,17,53,0,78
Ware 404 - Bickley UM Church,404 - Bickley UM Church,5,4,10,0,19
Ware 405 - Haywood Baptist Church,405 - Haywood Baptist Church,2,8,4,0,14
Ware 406 - Jamestown Baptist Church,406 - Jamestown Baptist Church,6,37,22,0,65
Ware 407 - Manor Commmunity Center,407 - Manor Commmunity Center,2,6,8,0,16
Ware 408 - Millwood Baptist Church,408 - Millwood Baptist Church,1,5,7,0,13
Ware 409 - Waresboro Church of God,409 - Waresboro Church of God,2,24,14,0,40
Warren Warrenton,Warrenton,141,555,384,1,1081
Washington Riddleville,Riddleville,15,49,56,0,120
Washington Warthen,Warthen,18,52,99,0,169
Washington Tennille,Tennille,73,376,311,0,760
Washington Oconee,Oconee,24,62,67,0,153
Washington Harrison,Harrison,23,91,89,0,203
Washington Davisboro,Davisboro,21,63,108,0,192
Washington Sandersville,Sandersville,316,1121,543,1,1981
Washington Deepstep,Deepstep,18,32,37,0,87
Wayne Odum,Odum,8,17,30,0,55
Wayne Madray Springs,Madray Springs,4,22,6,0,32
Wayne Oglethorpe,Oglethorpe,4,72,27,0,103
Wayne Screven,Screven,10,59,56,0,125
Wayne Empire,Empire,8,25,12,0,45
Wayne Red Hill,Red Hill,7,64,20,0,91
Wayne Altamaha,Altamaha,22,168,59,0,249
Wayne Gardi,Gardi,7,25,17,0,49
Wayne VFW,VFW,26,258,80,1,365
Wayne Pine Street,Pine Street,10,130,60,0,200
Wayne Unity,Unity,12,175,67,0,254
Wayne Rec Center,Rec Center,12,132,84,0,228
Webster Preston 1,Preston 1,71,196,157,1,425
Wheeler Alamo,Alamo,31,182,116,1,330
Wheeler Glenwood,Glenwood,12,84,75,0,171
White Blue Creek,Blue Creek,27,168,63,0,258
White Blue Ridge,Blue Ridge,4,44,24,0,72
White Robertstown-Helen,Robertstown-Helen,7,77,33,0,117
White Mossy Creek,Mossy Creek,11,92,59,0,162
White Mt Yonah,Mt Yonah,31,226,77,0,334
White Nacoochee,Nacoochee,42,139,72,0,253
White Shoal Creek,Shoal Creek,20,73,31,0,124
White Tesnatee,Tesnatee,10,60,28,0,98
White Town Creek,Town Creek,20,88,26,0,134
White White Creek,White Creek,8,45,13,0,66
Whitefield 1A,1A,35,180,178,0,393
Whitefield 2A,2A,23,203,165,0,391
Whitefield 3A,3A,18,173,142,0,333
Whitefield 4A,4A,24,223,143,1,391
Whitefield 5A,5A,20,151,212,0,383
Whitefield 6A,6A,18,95,183,0,296
Whitefield AN,AN,8,146,145,0,299
Whitefield CA,CA,7,45,74,0,126
Whitefield CO,CO,15,31,70,1,117
Whitefield DG,DG,28,159,198,0,385
Whitefield ES,ES,15,70,89,0,174
Whitefield FI,FI,6,98,108,1,213
Whitefield GL,GL,20,109,154,1,284
Whitefield LT,LT,5,25,31,0,61
Whitefield MC,MC,4,54,55,0,113
Whitefield NI,NI,19,57,77,0,153
Whitefield PG,PG,24,253,203,1,481
Whitefield TH,TH,42,146,138,1,327
Whitefield TI,TI,3,15,23,0,41
Whitefield TR,TR,7,27,43,0,77
Whitefield UT,UT,4,21,44,0,69
Whitefield VA,VA,45,239,235,1,520
Whitefield WS,WS,17,146,84,0,247
Wilcox Rochelle North #1,Rochelle North #1,11,65,75,0,151
Wilcox Abbeville North #2,Abbeville North #2,9,49,21,0,79
Wilcox Pineview #2,Pineview #2,12,46,82,0,140
Wilcox Pitts #3,Pitts #3,3,20,30,0,53
Wilcox Rochelle South #4,Rochelle South #4,4,35,26,0,65
Wilcox Abbeville South #5,Abbeville South #5,4,73,48,0,125
Wilkes Senior Citizen Center,Senior Citizen Center,62,273,159,0,494
Wilkes Young Famer's Bldg,Young Famer's Bldg,14,94,56,0,164
Wilkes Metasville Fire Sta,Metasville Fire Sta,21,46,21,0,88
Wilkes Edward B Pope Center,Edward B Pope Center,20,197,125,0,342
Wilkes Rayle City Hall,Rayle City Hall,11,36,60,0,107
Wilkes Courthouse,Courthouse,27,117,48,1,193
Wilkes Tignall Sch Lunch Rm,Tignall Sch Lunch Rm,27,76,92,0,195
Wilkenson Bloodworth,Bloodworth,1,12,5,0,18
Wilkenson Griffin,Griffin,5,6,13,0,24
Wilkenson High Hill,High Hill,0,9,14,0,23
Wilkenson Irwinton,Irwinton,45,180,85,0,310
Wilkenson Ivey,Ivey,2,27,23,0,52
Wilkenson Lord,Lord,19,76,102,0,197
Wilkenson Midway,Midway,57,212,163,0,432
Wilkenson Ramah,Ramah,62,227,248,1,538
Wilkenson Turkey Creek,Turkey Creek,5,22,52,0,79
Worth Sylvester ,Sylvester ,83,518,300,0,901
Worth Scooterville ,Scooterville ,5,11,5,0,21
Worth Minton,Minton,5,27,17,0,49
Worth Bridgeboro,Bridgeboro,4,42,33,1,80
Worth County Line,County Line,8,30,19,0,57
Worth Isabella ,Isabella ,3,34,17,0,54
Worth Sylvester East,Sylvester East,11,96,42,0,149
Worth Poulan ,Poulan ,7,40,28,0,75
Worth Sumner,Sumner,7,32,39,1,79
Worth Red Rock,Red Rock,7,68,46,0,121
Worth Doles,Doles,2,8,7,0,17
Worth Warwick,Warwick,25,18,70,0,113
