ID,Counties,Absentee by Mail Votes,Advance Voting Votes,Election Day Votes,Provisional Votes,Total
Appling 1B,1B,43,344,361,0,748
Appling 1C,1C,22,304,253,0,579
Appling 2,2,25,197,198,0,420
Appling 3A1,3A1,19,205,287,0,511
Appling 3C,3C,42,428,280,0,750
Appling 4B,4B,17,215,378,1,611
Appling 4D,4D,47,435,348,0,830
Appling 5A,5A,23,283,262,0,568
Appling 5B,5B,12,243,280,0,535
Atkinson Pearson County,Pearson County,19,519,325,1,864
Atkinson Axson,Axson,6,87,251,0,344
Atkinson Willacoochee,Willacoochee,9,157,258,1,425
Atkinson Pearson City,Pearson City,6,72,55,1,134
Bacon Douglas,Douglas,85,2364,863,0,3312
Baker Anna,Anna,7,45,94,0,146
Baker Elmodel,Elmodel,12,80,56,0,148
Baker Hoggards Mill,Hoggards Mill,3,38,65,1,107
Baker Milford,Milford,13,84,108,0,205
Baker Newton,Newton,8,87,52,2,149
Baldwin Scottboro,Scottboro,17,152,180,0,349
Baldwin North Baldwin,North Baldwin,75,1160,596,0,1831
Baldwin West Baldwin,West Baldwin,17,382,284,0,683
Baldwin East Hardwick,East Hardwick,3,40,47,0,90
Baldwin West Hardwick,West Hardwick,18,199,117,0,334
Baldwin Coopers,Coopers,11,296,389,0,696
Baldwin South Milledgeville,South Milledgeville,6,65,44,0,115
Baldwin City Hall Annex,City Hall Annex,8,45,39,0,92
Baldwin Boddie,Boddie,1,72,32,0,105
Baldwin Courthouse,Courthouse,5,53,29,0,87
Baldwin West Thomas,West Thomas,12,92,46,0,150
Baldwin North Milledgeville,North Milledgeville,28,465,208,0,701
Baldwin Meriwether,Meriwether,61,801,440,0,1302
Baldwin East Baldwin,East Baldwin,69,888,495,0,1452
Banks Anderson,Anderson,22,470,279,0,771
Banks Baldwin,Baldwin,39,253,151,0,443
Banks Berlin,Berlin,8,196,116,0,320
Banks Bushville,Bushville,9,267,163,0,439
Banks Columbia,Columbia,7,130,77,0,214
Banks Davids,Davids,19,514,373,1,907
Banks Golden Hill,Golden Hill,12,261,143,3,419
Banks Grove River,Grove River,16,188,133,0,337
Banks Hollingsworth,Hollingsworth,16,226,123,0,365
Banks Homer,Homer,18,489,268,0,775
Banks Poplar Springs,Poplar Springs,42,582,308,0,932
Banks Washington,Washington,10,265,117,1,393
Banks Wilmonts,Wilmonts,8,215,113,0,336
Barrow 01,01,42,634,759,0,1435
Barrow 02,02,145,1825,1498,1,3469
Barrow 03,03,87,996,1317,0,2400
Barrow 04,04,37,704,689,0,1430
Barrow 05,05,134,1907,1623,1,3665
Barrow 08,08,122,2035,1156,0,3313
Barrow 13,13,140,1877,1267,1,3285
Barrow 16,16,81,1391,1364,0,2836
Bartow Adairsville,Adairsville,91,1643,1375,3,3112
Bartow Allatoona,Allatoona,40,797,703,1,1541
Bartow Cartersville East,Cartersville East,126,1301,840,2,2269
Bartow Cartersville West,Cartersville West,139,2365,1181,1,3686
Bartow Cassville,Cassville,70,916,617,0,1603
Bartow Center,Center,76,973,993,1,2043
Bartow Emerson,Emerson,58,565,731,1,1355
Bartow Euharlee,Euharlee,52,1056,1267,2,2377
Bartow Folsom,Folsom,19,235,482,2,738
Bartow Kingston,Kingston,36,517,799,0,1352
Bartow Mission Road,Mission Road,74,954,677,2,1707
Bartow Pine Log,Pine Log,34,391,803,2,1230
Bartow Taylorsville,Taylorsville,29,494,1072,0,1595
Bartow White,White,43,600,800,1,1444
Bartow Zena Drive,Zena Drive,102,1021,726,3,1852
Bartow Hamilton Crossing,Hamilton Crossing,114,1628,1110,3,2855
Bartow Woodland,Woodland,51,326,390,2,769
Ben Hill East,East,81,2375,954,2,3412
Berrien West Berrien,West Berrien,23,177,391,0,591
Berrien Ray City ,Ray City ,22,387,407,0,816
Berrien Nashville,Nashville,129,1757,899,1,2786
Berrien Enigma,Enigma,8,98,379,0,485
Berrien Alapaha ,Alapaha ,13,165,352,1,531
Bibb East Macon 1,East Macon 1,4,11,9,0,24
Bibb East Macon 2,East Macon 2,15,51,39,0,105
Bibb East Macon 3,East Macon 3,39,236,214,1,490
Bibb East Macon 4,East Macon 4,3,26,32,0,61
Bibb East Macon 5,East Macon 5,18,110,156,0,284
Bibb Godfrey 1,Godfrey 1,21,86,104,1,212
Bibb Godfrey 2,Godfrey 2,10,24,30,0,64
Bibb Godfrey 3,Godfrey 3,8,56,36,2,102
Bibb Godfrey 4,Godfrey 4,7,37,31,0,75
Bibb Godfrey 5,Godfrey 5,23,93,112,0,228
Bibb Hazzard 1,Hazzard 1,19,70,63,0,152
Bibb Hazzard 2,Hazzard 2,44,286,620,0,950
Bibb Hazzard 3,Hazzard 3,72,482,415,1,970
Bibb Hazzard 4,Hazzard 4,95,835,989,4,1923
Bibb Howard 1,Howard 1,125,802,694,1,1622
Bibb Howard 2,Howard 2,113,746,753,3,1615
Bibb Howard 3,Howard 3,109,940,953,3,2005
Bibb Howard 4,Howard 4,28,265,183,0,476
Bibb Howard 5,Howard 5,32,160,230,0,422
Bibb Howard 6,Howard 6,48,390,292,0,730
Bibb Howard 7,Howard 7,48,550,638,1,1237
Bibb Rutland 1,Rutland 1,104,732,1244,1,2081
Bibb Rutland 2,Rutland 2,56,381,852,0,1289
Bibb Vineville 1,Vineville 1,25,228,310,0,563
Bibb Vineville 2,Vineville 2,11,91,142,1,245
Bibb Vineville 3,Vineville 3,11,64,38,0,113
Bibb Vineville 4,Vineville 4,15,102,107,0,224
Bibb Vineville 5,Vineville 5,51,350,376,0,777
Bibb Vineville 6,Vineville 6,21,378,446,0,845
Bibb Warrior 1,Warrior 1,44,286,838,3,1171
Bibb Warrior 2,Warrior 2,48,469,824,0,1341
Bleckley 1,1,152,2241,1492,1,3886
Brantley Hoboken,Hoboken,35,819,897,0,1751
Brantley Nahunta,Nahunta,49,1108,797,0,1954
Brantley Waynesville,Waynesville,15,725,971,0,1711
Brooks Quitman ,Quitman ,31,479,274,1,785
Brooks Barwick,Barwick,2,41,123,0,166
Brooks Dixie,Dixie,5,137,170,2,314
Brooks Briggs,Briggs,25,382,535,0,942
Brooks Pavo,Pavo,3,71,208,0,282
Brooks Nankin,Nankin,4,136,207,0,347
Brooks Morven,Morven,16,336,452,4,808
Bryan Harn Community Center,Harn Community Center,15,540,313,0,868
Bryan Danielsiding,Danielsiding,25,562,350,0,937
Bryan Christ Baptist Church,Christ Baptist Church,36,827,625,0,1488
Bryan Black Creek,Black Creek,18,260,327,0,605
Bryan First Baptist Church,First Baptist Church,27,671,437,0,1135
Bryan RH Rec Complex,RH Rec Complex,23,529,269,0,821
Bryan John Stevens Wetland Ctr,John Stevens Wetland Ctr,53,1125,358,0,1536
Bryan New Life,New Life,29,1370,654,0,2053
Bryan New Beginnings,New Beginnings,43,1012,482,0,1537
Bryan Bryan County Admin Bldg,Bryan County Admin Bldg,23,736,449,0,1208
Bulloch Lockhart,Lockhart,5,82,254,1,342
Bulloch Emit,Emit,47,670,711,0,1428
Bulloch Statesboro,Statesboro,93,1003,637,0,1733
Bulloch Portal,Portal,14,225,479,1,719
Bulloch Fair,Fair,118,1366,760,5,2249
Bulloch Church,Church,77,908,569,3,1557
Bulloch Pittman Park,Pittman Park,31,331,291,2,655
Bulloch Leefield,Leefield,15,124,400,1,540
Bulloch Blitch,Blitch,25,438,574,0,1037
Bulloch Hagin,Hagin,27,354,574,0,955
Bulloch Brooklet,Brooklet,51,724,935,2,1712
Bulloch Stilson,Stilson,18,293,741,0,1052
Bulloch Bay,Bay,23,223,608,1,855
Bulloch Nevils,Nevils,19,214,411,0,644
Bulloch Sinkhole,Sinkhole,7,57,189,0,253
Bulloch Register,Register,10,127,198,1,336
Burke Alexander,Alexander,2,33,92,0,127
Burke Four Points,Four Points,27,310,569,0,906
Burke Girard,Girard,16,61,128,0,205
Burke Gough,Gough,5,43,58,0,106
Burke Greenscut,Greenscut,12,148,197,0,357
Burke Keysville,Keysville,2,24,81,0,107
Burke Midville,Midville,2,20,94,0,116
Burke Munnerlyn,Munnerlyn,2,36,58,0,96
Burke Sardis,Sardis,8,69,251,0,328
Burke Scotts Crossroads,Scotts Crossroads,0,15,42,0,57
Burke Telfair,Telfair,11,93,200,0,304
Burke St Clair,St Clair,7,72,106,0,185
Burke Vidette,Vidette,2,19,75,2,98
Burke North Waynesboro,North Waynesboro,19,279,121,0,419
Burke South Waynesboro,South Waynesboro,40,674,408,1,1123
Burke Blakeney,Blakeney,1,76,74,0,151
Butts Butts County Recreation Center,Butts County Recreation Center,71,1229,298,0,1598
Butts Jenkinsburg City Hall,Jenkinsburg City Hall,33,1013,336,0,1382
Butts Rock Creek Missionary,Rock Creek Missionary,23,445,161,1,630
Butts Stark United Methodist Church,Stark United Methodist Church,54,1308,538,0,1900
Butts Towaliga Baptist Church,Towaliga Baptist Church,48,1253,411,1,1713
Calhoun Leary ,Leary ,7,124,87,0,218
Calhoun Morgan,Morgan,20,128,120,0,268
Calhoun Edison ,Edison ,4,18,40,0,62
Calhoun Edison-Arlington,Edison-Arlington,4,79,78,0,161
Calhoun Arlington,Arlington,2,43,39,0,84
Camden Tarboro,Tarboro,7,161,253,0,421
Camden Waverly,Waverly,33,376,421,1,831
Camden Woodbine,Woodbine,17,320,356,0,693
Camden Browntown,Browntown,5,116,165,0,286
Camden Harriets Bluff,Harriets Bluff,23,425,452,0,900
Camden West Kingsland,West Kingsland,24,579,387,0,990
Camden North Kingsland,North Kingsland,8,300,236,0,544
Camden Kingsland,Kingsland,12,320,222,0,554
Camden East Kingsland,East Kingsland,71,1509,844,2,2426
Camden North St. Marys,North St. Marys,22,166,177,0,365
Camden St. Marys ,St. Marys ,18,429,451,0,898
Camden South St. Marys,South St. Marys,38,472,348,0,858
Camden Mush Bluff,Mush Bluff,18,528,452,0,998
Camden West St. Marys ,West St. Marys ,86,1122,522,0,1730
Candler JSCC,JSCC,52,1849,763,2,2666
Carroll Kansas,Kansas,19,167,501,0,687
Carroll Bowdon,Bowdon,32,440,850,0,1322
Carroll Sandhill,Sandhill,43,865,791,0,1699
Carroll Center Point,Center Point,37,467,632,0,1136
Carroll Mt Zion,Mt Zion,20,400,801,1,1222
Carroll Burwell,Burwell,25,256,468,1,750
Carroll Clem,Clem,33,1010,789,1,1833
Carroll Bowdon Junction,Bowdon Junction,14,306,366,0,686
Carroll Tyus,Tyus,19,300,753,0,1072
Carroll Fairfield,Fairfield,32,687,1144,0,1863
Carroll Hulett,Hulett,24,522,705,0,1251
Carroll Bethany,Bethany,26,717,547,0,1290
Carroll V R County South,V R County South,20,726,470,0,1216
Carroll V R County North,V R County North,36,1023,778,0,1837
Carroll Villa Rica City,Villa Rica City,57,864,562,0,1483
Carroll Temple County,Temple County,47,742,839,0,1628
Carroll Temple City,Temple City,28,415,749,1,1193
Carroll Whitesburg,Whitesburg,25,352,697,1,1075
Carroll Roopville,Roopville,25,721,975,0,1721
Carroll West Carrollton,West Carrollton,25,421,223,0,669
Carroll Lakeshore Rec Center,Lakeshore Rec Center,28,311,159,0,498
Carroll Bonner,Bonner,39,852,416,0,1307
Carroll University of W GA,University of W GA,10,401,208,0,619
Carroll County Admin Bldg,County Admin Bldg,23,583,277,1,884
Carroll Tabernacle Church,Tabernacle Church,46,391,237,0,674
Carroll Burson Center,Burson Center,4,357,197,0,558
Carroll Old Camp Church,Old Camp Church,22,565,542,0,1129
Carroll Oak Grove,Oak Grove,18,312,463,0,793
Catoosa Blackstock,Blackstock,17,361,513,0,891
Catoosa Boynton,Boynton,82,1644,1089,2,2817
Catoosa Catoosa Keith,Catoosa Keith,25,595,643,0,1263
Catoosa Chambers,Chambers,31,819,634,0,1484
Catoosa Ft Oglethorpe,Ft Oglethorpe,44,875,604,2,1525
Catoosa Graysville,Graysville,47,965,853,3,1868
Catoosa Lakeview,Lakeview,25,681,443,0,1149
Catoosa Poplar Springs,Poplar Springs,51,1139,750,3,1943
Catoosa Ringgold,Ringgold,94,2116,1068,1,3279
Catoosa Westside,Westside,64,1532,679,2,2277
Catoosa Woodstation,Woodstation,19,688,805,1,1513
Charlton Folkston,Folkston,33,930,513,2,1478
Charlton GA Bend,GA Bend,7,18,207,1,233
Charlton St. George ,St. George ,11,41,225,1,278
Charlton Homeland,Homeland,7,173,168,1,349
Charlton Racepond,Racepond,1,60,109,0,170
Charlton Winokur,Winokur,6,53,87,0,146
Chatham 1-01C First Presbyterian Church,1-01C First Presbyterian Church,51,308,548,1,908
Chatham 1-05C JEA Building,1-05C JEA Building,32,178,338,0,548
Chatham 1-06C Central Church of Christ,1-06C Central Church of Christ,59,265,426,0,750
Chatham 1-08C Grace United Methodist Church,1-08C Grace United Methodist Church,28,178,371,0,577
Chatham 1-09C Immanuel Baptist Church,1-09C Immanuel Baptist Church,11,106,145,0,262
Chatham 1-10C St Thomas Episcopal Church,1-10C St Thomas Episcopal Church,24,141,451,0,616
Chatham 1-12C Isle of Hope Baptist,1-12C Isle of Hope Baptist,46,427,628,0,1101
Chatham 1-13C The Sanctuary,1-13C The Sanctuary,18,184,301,0,503
Chatham 1-14C St. Luke United Methodist Church,1-14C St. Luke United Methodist Church,56,336,345,0,737
Chatham 1-16C Ferguson Ave Baptist,1-16C Ferguson Ave Baptist,46,484,872,0,1402
Chatham 1-17C Islands Christian Church,1-17C Islands Christian Church,87,867,623,0,1577
Chatham 2-02C River Pointe,2-02C River Pointe,10,69,71,0,150
Chatham 2-03C W W Law Center,2-03C W W Law Center,2,39,68,0,109
Chatham 2-04C Fellowship of Love Church,2-04C Fellowship of Love Church,3,36,61,0,100
Chatham 2-05C Holy Spirit Lutheran Church,2-05C Holy Spirit Lutheran Church,5,46,76,0,127
Chatham 2-06C Eli Whitney Complex - Savannah,2-06C Eli Whitney Complex - Savannah,2,18,33,0,53
Chatham 2-06C Eli Whitney Complex,2-06C Eli Whitney Complex,17,172,96,0,285
Chatham 2-07C Christ Community Church,2-07C Christ Community Church,13,68,114,0,195
Chatham 2-09C Salvation Army,2-09C Salvation Army,12,81,135,0,228
Chatham 2-11C Oasis of Hope,2-11C Oasis of Hope,6,52,53,0,111
Chatham 2-12C Williams Court Apts,2-12C Williams Court Apts,7,25,84,0,116
Chatham 3-02C Temple Mickve Israel,3-02C Temple Mickve Israel,22,209,173,1,405
Chatham 3-03C Savannah High School,3-03C Savannah High School,4,25,26,0,55
Chatham 3-04C First African Baptist Church,3-04C First African Baptist Church,1,17,14,0,32
Chatham 3-05C New Generations Cathedral,3-05C New Generations Cathedral,11,80,117,0,208
Chatham 3-08C Jenkins High School,3-08C Jenkins High School,12,71,107,0,190
Chatham 3-09C The Connexion Church,3-09C The Connexion Church,15,52,207,0,274
Chatham 3-10C Bible Baptist Church,3-10C Bible Baptist Church,8,56,115,0,179
Chatham 3-11C Southside Baptist Church,3-11C Southside Baptist Church,5,50,79,0,134
Chatham 3-12C Thunderbolt Muni Complex,3-12C Thunderbolt Muni Complex,18,128,303,0,449
Chatham 3-13C New Cov 7 Day Adv Ch,3-13C New Cov 7 Day Adv Ch,24,219,237,0,480
Chatham 3-14C Oglethorpe Charter Academy,3-14C Oglethorpe Charter Academy,25,133,120,1,279
Chatham 3-14C Oglethorpe Charter Academy - Savannah,3-14C Oglethorpe Charter Academy - Savannah,1,21,17,0,39
Chatham 4-02C Islands High School Annex,4-02C Islands High School Annex,25,421,438,0,884
Chatham 4-04C Lighthouse Baptist Church,4-04C Lighthouse Baptist Church,40,432,600,0,1072
Chatham 4-05C St Francis Episcopal Church,4-05C St Francis Episcopal Church,38,441,548,0,1027
Chatham 4-06C First Baptist of the Island,4-06C First Baptist of the Island,36,557,549,0,1142
Chatham 4-07C Wilmington Island UMC,4-07C Wilmington Island UMC,53,686,641,0,1380
Chatham 4-08C Wilmington Island Pres Church,4-08C Wilmington Island Pres Church,67,629,712,0,1408
Chatham 4-10C Burke Day Public Safety BLDG,4-10C Burke Day Public Safety BLDG,28,220,378,1,627
Chatham 4-11C Island Old School Cafe,4-11C Island Old School Cafe,21,192,486,1,700
Chatham 4-12C St Peters Episcopal,4-12C St Peters Episcopal,58,430,860,1,1349
Chatham 4-13C Skidaway Community Church,4-13C Skidaway Community Church,104,513,843,0,1460
Chatham 4-14C Skidaway Island Methodist Church,4-14C Skidaway Island Methodist Church,176,820,1112,1,2109
Chatham 5-02C Senior Citizens Center,5-02C Senior Citizens Center,3,12,25,0,40
Chatham 5-03C Butler Presbyterian Church,5-03C Butler Presbyterian Church,0,4,7,0,11
Chatham 5-05C Liberty City Comm Ctr,5-05C Liberty City Comm Ctr,1,13,32,0,46
Chatham 5-06C Seed Church,5-06C Seed Church,4,25,46,0,75
Chatham 5-06C Seed Church - Savannah,5-06C Seed Church - Savannah,6,15,33,0,54
Chatham 5-07C Elks Lodge,5-07C Elks Lodge,7,60,113,0,180
Chatham 5-08C Savannah Primitive BC,5-08C Savannah Primitive BC,13,100,136,0,249
Chatham 5-10C Jonesville Baptist Church,5-10C Jonesville Baptist Church,5,26,34,0,65
Chatham 5-11C Largo-Tibet Elementary,5-11C Largo-Tibet Elementary,51,138,86,0,275
Chatham 6-01C White Bluff Presbyterian,6-01C White Bluff Presbyterian,20,134,190,0,344
Chatham 6-02C Windsor Forest Baptist - Savannah,6-02C Windsor Forest Baptist - Savannah,36,375,434,0,845
Chatham 6-02C Windsor Forest Baptist,6-02C Windsor Forest Baptist,4,38,32,0,74
Chatham 6-03C Crusader Comm Center,6-03C Crusader Comm Center,32,330,323,0,685
Chatham 6-05C Windsor Hall,6-05C Windsor Hall,20,146,172,0,338
Chatham 6-06C The Light Church,6-06C The Light Church,26,172,162,0,360
Chatham 6-08C Christ Memorial Baptist Church,6-08C Christ Memorial Baptist Church,17,116,103,0,236
Chatham 6-09C Trinity Lutheran Church,6-09C Trinity Lutheran Church,41,394,337,1,773
Chatham 6-10C Georgetown Elementary,6-10C Georgetown Elementary,34,591,473,0,1098
Chatham 6-10C Georgetown Elementary - Savannah,6-10C Georgetown Elementary - Savannah,4,19,29,0,52
Chatham 6-11C Coastal GA Botanical Gardens,6-11C Coastal GA Botanical Gardens,21,181,202,0,404
Chatham 6-11C Coastal GA Botanical Gardens - Savannah,6-11C Coastal GA Botanical Gardens - Savannah,19,135,176,0,330
Chatham 7-01C First Baptist Church of Garden City,7-01C First Baptist Church of Garden City,13,130,255,0,398
Chatham 7-03C PB Edwards Gym,7-03C PB Edwards Gym,12,72,306,0,390
Chatham 7-04C Lake Shore Comm Ctr,7-04C Lake Shore Comm Ctr,8,69,227,0,304
Chatham 7-05C Woodlawn Baptist Church,7-05C Woodlawn Baptist Church,10,81,142,1,234
Chatham 7-06C 1st Baptist Church of Pooler,7-06C 1st Baptist Church of Pooler,46,366,341,1,754
Chatham 7-07C Rothwell Baptist Church,7-07C Rothwell Baptist Church,58,620,607,0,1285
Chatham 7-08C Bloomingdale Comm Ctr,7-08C Bloomingdale Comm Ctr,23,269,788,0,1080
Chatham 7-08C Bloomingdale Comm Ctr - Savannah,7-08C Bloomingdale Comm Ctr - Savannah,6,8,14,0,28
"Chatham 7-09C Compassion Christian, Henderson","7-09C Compassion Christian, Henderson",30,237,279,0,546
"Chatham 7-09C Compassion Christian, Henderson - Savannah","7-09C Compassion Christian, Henderson - Savannah",0,0,0,0,0
Chatham 7-10C Progressive Rec Center,7-10C Progressive Rec Center,44,292,297,0,633
Chatham 7-11C Savannah Fire Station 14,7-11C Savannah Fire Station 14,23,150,244,0,417
Chatham 7-12C West Chatham Baptist Church,7-12C West Chatham Baptist Church,30,335,357,1,723
Chatham 7-13C Southside Fire Trng Ctr,7-13C Southside Fire Trng Ctr,64,683,446,0,1193
Chatham 7-13C Southside Fire Trng Ctr - Garden City,7-13C Southside Fire Trng Ctr - Garden City,2,0,7,0,9
Chatham 7-14C Coastal Cathedral,7-14C Coastal Cathedral,90,592,727,1,1410
Chatham 7-15C Rice Creek School,7-15C Rice Creek School,14,119,296,0,429
Chatham 7-16C Pooler Recreation Center Gymnasium,7-16C Pooler Recreation Center Gymnasium,110,692,585,0,1387
Chatham 8-01C R.M.G. Civil Rights Museum,8-01C R.M.G. Civil Rights Museum,8,111,97,0,216
Chatham 8-02C Hellenic Center,8-02C Hellenic Center,4,62,76,0,142
Chatham 8-03C Silk Hope Baptist Church,8-03C Silk Hope Baptist Church,10,49,186,0,245
Chatham 8-03C Silk Hope Baptist Church - Garden City,8-03C Silk Hope Baptist Church - Garden City,0,0,1,0,1
Chatham 8-05C W Broad St YMCA,8-05C W Broad St YMCA,0,6,12,0,18
Chatham 8-06C Tompkins Rec Center,8-06C Tompkins Rec Center,0,4,5,0,9
Chatham 8-07C Woodville-Tompkins TI,8-07C Woodville-Tompkins TI,0,8,10,0,18
Chatham 8-08C Resur of Our Lord Church,8-08C Resur of Our Lord Church,2,5,11,0,18
Chatham 8-09C Moses Jackson Center,8-09C Moses Jackson Center,3,1,10,0,14
Chatham 8-10C Carver Heights Comm Ctr,8-10C Carver Heights Comm Ctr,2,2,6,0,10
Chatham 8-11C Butler Elementary,8-11C Butler Elementary,1,6,10,0,17
Chatham 8-12C Beach High School,8-12C Beach High School,3,36,44,0,83
Chatham 8-13C Savannah Christian,8-13C Savannah Christian,19,80,124,0,223
Chatham 8-15C Cooper Center,8-15C Cooper Center,1,20,28,0,49
Chatham 8-16C Mighty 8th Museum,8-16C Mighty 8th Museum,54,345,395,0,794
Chatham 8-17C Georgia Tech Savannah Campus,8-17C Georgia Tech Savannah Campus,16,168,276,2,462
Chatham 8-18C Savannah First 7th Day Adv Church,8-18C Savannah First 7th Day Adv Church,5,49,129,0,183
Chattahoochee Activity Center,Activity Center,19,251,313,0,583
Chattooga Haywood,Haywood,0,8,74,0,82
Chattooga Lyerly,Lyerly,16,320,413,0,749
Chattooga Trion,Trion,52,1138,924,0,2114
Chattooga Summerville,Summerville,84,1227,757,0,2068
Chattooga Dirttown,Dirttown,9,169,305,0,483
Chattooga Subligna,Subligna,12,89,190,0,291
Chattooga Menlo,Menlo,15,253,416,0,684
Cherokee Air Acres,Air Acres,76,538,658,0,1272
Cherokee Arnold Mill,Arnold Mill,113,1324,1045,0,2482
Cherokee Avery,Avery,98,1388,807,0,2293
Cherokee Ball Ground,Ball Ground,33,1416,795,0,2244
Cherokee Bascomb,Bascomb,82,1018,796,0,1896
Cherokee Bells,Bells,65,1075,812,0,1952
Cherokee Booth,Booth,80,1073,672,1,1826
Cherokee Bradshaw,Bradshaw,123,1467,821,0,2411
Cherokee Bridgemill,Bridgemill,123,1499,953,0,2575
Cherokee Canton,Canton,260,2386,981,2,3629
Cherokee Carmel,Carmel,89,721,674,4,1488
Cherokee Clayton,Clayton,120,1763,968,1,2852
Cherokee Conns Creek,Conns Creek,11,280,319,0,610
Cherokee Deer Run,Deer Run,45,486,725,0,1256
Cherokee Dixie,Dixie,77,981,809,0,1867
Cherokee Freehome,Freehome,184,1912,1220,0,3316
Cherokee Hickory Flat,Hickory Flat,165,2186,1526,1,3878
Cherokee Hightower,Hightower,87,1255,736,1,2079
Cherokee Hillside,Hillside,79,935,579,0,1593
Cherokee Holly Springs,Holly Springs,54,591,568,0,1213
Cherokee Kellogg,Kellogg,91,985,907,0,1983
Cherokee Liberty,Liberty,151,1647,1278,3,3079
Cherokee Little River,Little River,321,1878,1125,1,3325
Cherokee Macedonia,Macedonia,116,1614,1161,1,2892
Cherokee Mountain Road,Mountain Road,80,828,722,0,1630
Cherokee Neese,Neese,162,1497,1176,1,2836
Cherokee Oak Grove,Oak Grove,47,880,596,0,1523
Cherokee R M Moore,R M Moore,83,1129,890,0,2102
Cherokee R T Jones,R T Jones,40,544,293,1,878
Cherokee Rosecreek,Rosecreek,71,1015,675,0,1761
Cherokee Salacoa,Salacoa,13,111,305,0,429
Cherokee Sixes,Sixes,108,985,653,0,1746
Cherokee Sutallee,Sutallee,53,615,899,0,1567
Cherokee Teasley,Teasley,154,2054,1463,2,3673
Cherokee Toonigh,Toonigh,145,1610,1203,0,2958
Cherokee Union Hill,Union Hill,99,1254,1254,1,2608
Cherokee Univeter,Univeter,148,1710,927,0,2785
Cherokee Victoria,Victoria,39,660,641,0,1340
Cherokee Waleska,Waleska,103,946,751,0,1800
Cherokee Wildcat,Wildcat,60,662,741,2,1465
Cherokee Woodlands,Woodlands,46,433,869,0,1348
Cherokee Woodstock,Woodstock,131,1713,1018,0,2862
Clarke 1A,1A,41,330,292,0,663
Clarke 1B,1B,61,430,240,0,731
Clarke 1C,1C,47,240,230,0,517
Clarke 1D,1D,80,380,330,0,790
Clarke 2A,2A,33,126,186,1,346
Clarke 2B,2B,19,81,104,0,204
Clarke 3A,3A,12,55,53,0,120
Clarke 3B,3B,23,156,129,0,308
Clarke 4A,4A,14,103,84,2,203
Clarke 4B,4B,28,314,261,0,603
Clarke 5A,5A,60,302,259,0,621
Clarke 5B,5B,45,294,238,0,577
Clarke 5C,5C,11,61,98,0,170
Clarke 5D,5D,25,174,202,1,402
Clarke 6A,6A,66,634,357,0,1057
Clarke 6B,6B,81,484,318,1,884
Clarke 6C,6C,70,449,412,1,932
Clarke 6D,6D,27,103,150,0,280
Clarke 7A,7A,55,383,318,0,756
Clarke 7B,7B,87,431,236,0,754
Clarke 7C,7C,45,353,316,0,714
Clarke 8A,8A,46,298,187,0,531
Clarke 8B,8B,46,158,177,0,381
Clarke 8C,8C,41,209,297,0,547
Clay Bluffton,Bluffton,7,71,68,1,147
Clay Zetto ,Zetto ,8,44,24,0,76
Clay Court House,Court House,1,31,28,0,60
Clay Old Head Start,Old Head Start,7,80,22,0,109
Clay Days Cross Road,Days Cross Road,6,132,40,0,178
Clayton Ellenwood 1,Ellenwood 1,2,81,22,1,106
Clayton Ellenwood 2,Ellenwood 2,12,85,49,0,146
Clayton Forest Park 1,Forest Park 1,13,128,65,0,206
Clayton Forest Park 2,Forest Park 2,10,82,66,0,158
Clayton Forest Park 3,Forest Park 3,7,115,70,1,193
Clayton Forest Park 4,Forest Park 4,10,146,84,0,240
Clayton Forest Park 5,Forest Park 5,18,122,101,0,241
Clayton Forest Park 6,Forest Park 6,10,124,62,1,197
Clayton Jonesboro 1,Jonesboro 1,13,71,44,1,129
Clayton Jonesboro 2,Jonesboro 2,3,25,15,0,43
Clayton Jonesboro 3,Jonesboro 3,17,120,68,0,205
Clayton Jonesboro 4,Jonesboro 4,8,67,60,0,135
Clayton Jonesboro 5,Jonesboro 5,10,100,110,0,220
Clayton Jonesboro 6,Jonesboro 6,50,506,176,0,732
Clayton Jonesboro 7,Jonesboro 7,18,181,72,0,271
Clayton Jonesboro 8,Jonesboro 8,3,52,49,0,104
Clayton Jonesboro 9,Jonesboro 9,14,45,46,0,105
Clayton Jonesboro 10,Jonesboro 10,9,66,65,0,140
Clayton Jonesboro 11,Jonesboro 11,24,179,87,0,290
Clayton Jonesboro 12,Jonesboro 12,3,45,37,1,86
Clayton Jonesboro 13,Jonesboro 13,9,62,95,0,166
Clayton Jonesboro 14,Jonesboro 14,65,435,163,2,665
Clayton Jonesboro 15,Jonesboro 15,11,72,31,0,114
Clayton Jonesboro 16,Jonesboro 16,18,56,49,0,123
Clayton Jonesboro 17,Jonesboro 17,4,59,40,1,104
Clayton Jonesboro 18,Jonesboro 18,13,96,69,0,178
Clayton Jonesboro 19,Jonesboro 19,9,64,37,0,110
Clayton Jonesboro 20,Jonesboro 20,3,39,28,0,70
Clayton Jonesboro 21,Jonesboro 21,6,79,46,0,131
Clayton Jonesboro 22,Jonesboro 22,3,74,35,0,112
Clayton Lake City,Lake City,3,89,64,0,156
Clayton Lovejoy 1,Lovejoy 1,16,167,83,0,266
Clayton Lovejoy 2,Lovejoy 2,4,107,66,0,177
Clayton Lovejoy 3,Lovejoy 3,13,85,26,0,124
Clayton Lovejoy 4,Lovejoy 4,13,87,40,0,140
Clayton Lovejoy 5,Lovejoy 5,6,80,36,1,123
Clayton Lovejoy 6,Lovejoy 6,9,113,45,0,167
Clayton Lovejoy 7,Lovejoy 7,16,128,66,0,210
Clayton Lovejoy 8,Lovejoy 8,2,30,20,0,52
Clayton Morrow 1,Morrow 1,7,77,62,0,146
Clayton Morrow 2,Morrow 2,6,204,89,0,299
Clayton Morrow 3,Morrow 3,16,151,84,0,251
Clayton Morrow 4,Morrow 4,17,101,66,0,184
Clayton Morrow 5,Morrow 5,5,94,49,0,148
Clayton Morrow 6,Morrow 6,10,132,91,0,233
Clayton Morrow 7,Morrow 7,10,82,55,0,147
Clayton Morrow 8,Morrow 8,10,78,63,0,151
Clayton Morrow 9,Morrow 9,5,55,35,0,95
Clayton Morrow 10,Morrow 10,16,153,51,0,220
Clayton Morrow 11,Morrow 11,3,50,53,1,107
Clayton Oak 1,Oak 1,7,26,20,0,53
Clayton Oak 2,Oak 2,1,21,20,0,42
Clayton Oak 3,Oak 3,0,23,19,0,42
Clayton Oak 4,Oak 4,2,29,26,0,57
Clayton Oak 5,Oak 5,3,25,10,0,38
Clayton Oak 6,Oak 6,4,21,12,0,37
Clayton Panhandle 1,Panhandle 1,10,81,49,0,140
Clayton Panhandle 2,Panhandle 2,21,286,139,0,446
Clayton Riverdale 1,Riverdale 1,5,56,29,0,90
Clayton Riverdale 2,Riverdale 2,4,38,37,0,79
Clayton Riverdale 3,Riverdale 3,14,66,24,2,106
Clayton Riverdale 4,Riverdale 4,25,93,55,0,173
Clayton Riverdale 5,Riverdale 5,14,54,44,0,112
Clayton Riverdale 6,Riverdale 6,11,80,55,0,146
Clayton Riverdale 7,Riverdale 7,9,68,56,0,133
Clayton Riverdale 8,Riverdale 8,17,86,36,0,139
Clayton Riverdale 9,Riverdale 9,12,68,59,0,139
Clayton Riverdale 10,Riverdale 10,1,23,17,0,41
Clayton Riverdale 11,Riverdale 11,6,34,32,0,72
Clayton Riverdale 12,Riverdale 12,15,41,49,0,105
Clinch Arabia,Arabia,0,8,55,0,63
Clinch Argyle,Argyle,0,55,113,0,168
Clinch Dupont,Dupont,4,39,94,0,137
Clinch Fargo,Fargo,0,16,112,0,128
Clinch Homerville,Homerville,29,767,376,0,1172
Cobb Acworth 1A,Acworth 1A,114,1081,507,1,1703
Cobb Acworth 1B,Acworth 1B,93,934,531,5,1563
Cobb Acworth 1C,Acworth 1C,32,537,298,3,870
Cobb Addison 01,Addison 01,65,459,329,1,854
Cobb Austell 1A,Austell 1A,14,188,96,1,299
Cobb Austell 1B,Austell 1B,8,100,39,1,148
Cobb Baker 01,Baker 01,47,516,464,2,1029
Cobb Bells Ferry 02,Bells Ferry 02,60,377,502,1,940
Cobb Bells Ferry 03,Bells Ferry 03,35,254,329,0,618
Cobb Bells Ferry 04,Bells Ferry 04,55,513,640,0,1208
Cobb Big Shanty 01,Big Shanty 01,63,341,308,1,713
Cobb Big Shanty 02,Big Shanty 02,61,492,502,0,1055
Cobb Birney 01,Birney 01,50,233,216,1,500
Cobb Birney 02,Birney 02,72,433,278,0,783
Cobb Bryant 01,Bryant 01,9,32,38,0,79
Cobb Bryant 02,Bryant 02,11,84,75,0,170
Cobb Blackwell 01,Blackwell 01,39,343,373,0,755
Cobb Chattahoochee 01,Chattahoochee 01,34,360,363,2,759
Cobb Cheatham Hill 02,Cheatham Hill 02,88,743,520,1,1352
Cobb Cheatham Hill 03,Cheatham Hill 03,116,873,542,0,1531
Cobb Chalker 01,Chalker 01,113,524,415,1,1053
Cobb Clarkdale 01,Clarkdale 01,21,189,147,0,357
Cobb Clarkdale 02,Clarkdale 02,46,421,342,1,810
Cobb Cooper 01,Cooper 01,46,274,188,0,508
Cobb Chestnut Ridge 01,Chestnut Ridge 01,80,741,588,0,1409
Cobb Dickerson 01,Dickerson 01,105,586,510,0,1201
Cobb Dobbins 01,Dobbins 01,18,126,118,0,262
Cobb Dobbins 02,Dobbins 02,20,206,251,1,478
Cobb Dowell 01,Dowell 01,47,541,427,0,1015
Cobb Dodgen 01,Dodgen 01,54,359,453,1,867
Cobb Durham 01,Durham 01,94,1392,615,1,2102
Cobb Davis 01,Davis 01,22,322,391,0,735
Cobb Eastside 01,Eastside 01,103,664,527,0,1294
Cobb Eastside 02,Eastside 02,154,912,600,0,1666
Cobb Elizabeth 01,Elizabeth 01,18,258,297,2,575
Cobb Elizabeth 02,Elizabeth 02,86,370,406,1,863
Cobb Elizabeth 03,Elizabeth 03,107,585,469,1,1162
Cobb Elizabeth 04,Elizabeth 04,30,253,371,1,655
Cobb Elizabeth 05,Elizabeth 05,55,503,447,0,1005
Cobb East Piedmont 01,East Piedmont 01,40,228,342,1,611
Cobb Fair Oaks 02,Fair Oaks 02,56,405,304,1,766
Cobb Fair Oaks 04,Fair Oaks 04,60,259,223,4,546
Cobb Fullers Park 01,Fullers Park 01,99,631,613,0,1343
Cobb Ford 01,Ford 01,71,931,553,1,1556
Cobb Frey 01,Frey 01,80,817,344,1,1242
Cobb Garrison Mill 01,Garrison Mill 01,49,627,469,1,1146
Cobb Gritters 01,Gritters 01,80,636,663,1,1380
Cobb Harmony-Leland 01,Harmony-Leland 01,16,131,92,0,239
Cobb Harmony-Leland 02,Harmony-Leland 02,30,206,136,0,372
Cobb Harrison 01,Harrison 01,68,930,510,0,1508
Cobb Hightower 01,Hightower 01,157,992,579,3,1731
Cobb Hayes 01,Hayes 01,74,1126,532,1,1733
Cobb Kennesaw 1A,Kennesaw 1A,24,323,243,1,591
Cobb Kennesaw 2A,Kennesaw 2A,59,602,424,0,1085
Cobb Kennesaw 3A,Kennesaw 3A,89,744,418,6,1257
Cobb Kennesaw 4A,Kennesaw 4A,71,582,379,0,1032
Cobb Kennesaw 5A,Kennesaw 5A,55,789,815,0,1659
Cobb Kell 01,Kell 01,40,272,413,2,727
Cobb Kemp 01,Kemp 01,42,560,368,2,972
Cobb Kemp 02,Kemp 02,137,929,556,1,1623
Cobb Kemp 03,Kemp 03,91,1231,690,0,2012
Cobb Lassiter 01,Lassiter 01,78,826,547,2,1453
Cobb Lindley 01,Lindley 01,58,389,290,0,737
Cobb Lost Mountain 01,Lost Mountain 01,84,1074,334,0,1492
Cobb Lost Mountain 02,Lost Mountain 02,102,1316,643,2,2063
Cobb Lost Mountain 03,Lost Mountain 03,109,1710,537,0,2356
Cobb Lost Mountain 04,Lost Mountain 04,57,738,382,0,1177
Cobb Mableton 01,Mableton 01,91,566,215,3,875
Cobb Mableton 02,Mableton 02,30,215,168,2,415
Cobb Mableton 03,Mableton 03,57,434,303,0,794
Cobb Mableton 04,Mableton 04,42,264,191,0,497
Cobb Mabry 01,Mabry 01,44,386,351,1,782
Cobb Macland 01,Macland 01,26,379,241,0,646
Cobb Murdock 01,Murdock 01,117,848,673,1,1639
Cobb McEachern 01,McEachern 01,74,527,273,1,875
Cobb McCleskey 01,McCleskey 01,34,373,359,0,766
Cobb McClure 01,McClure 01,70,808,541,1,1420
Cobb Marietta 1A,Marietta 1A,44,353,230,1,628
Cobb Marietta 2A,Marietta 2A,60,392,430,1,883
Cobb Marietta 2B,Marietta 2B,64,608,441,0,1113
Cobb Marietta 3A,Marietta 3A,106,708,590,0,1404
Cobb Marietta 3B,Marietta 3B,16,84,89,0,189
Cobb Marietta 4A,Marietta 4A,58,552,542,1,1153
Cobb Marietta 4B,Marietta 4B,46,298,302,1,647
Cobb Marietta 4C,Marietta 4C,68,756,524,0,1348
Cobb Marietta 5A,Marietta 5A,44,316,228,1,589
Cobb Marietta 5B,Marietta 5B,8,114,122,0,244
Cobb Marietta 6A,Marietta 6A,20,117,96,1,234
Cobb Marietta 6B,Marietta 6B,52,417,444,0,913
Cobb Marietta 7A,Marietta 7A,18,107,126,0,251
Cobb Mars Hill 01,Mars Hill 01,67,1028,659,0,1754
Cobb Mars Hill 02,Mars Hill 02,31,489,433,2,955
Cobb Mt. Bethel 01,Mt. Bethel 01,135,947,699,1,1782
Cobb Mt. Bethel 03,Mt. Bethel 03,102,811,389,3,1305
Cobb Mt. Bethel 04,Mt. Bethel 04,92,724,455,1,1272
Cobb North Cobb 01,North Cobb 01,36,350,292,1,679
Cobb Nickajack 01,Nickajack 01,38,319,272,0,629
Cobb Norton Park 01,Norton Park 01,77,481,406,2,966
Cobb Nicholson 01,Nicholson 01,51,372,370,0,793
Cobb Oakdale 01,Oakdale 01,94,538,401,0,1033
Cobb Oregon 01,Oregon 01,38,409,270,0,717
Cobb Oregon 02,Oregon 02,90,429,288,0,807
Cobb Oregon 03,Oregon 03,57,353,246,1,657
Cobb Oregon 04,Oregon 04,65,455,234,1,755
Cobb Oregon 05,Oregon 05,56,560,425,2,1043
Cobb Pebblebrook 01,Pebblebrook 01,36,257,168,0,461
Cobb Powers Ferry 01,Powers Ferry 01,73,465,460,0,998
Cobb Pine Mountain 01,Pine Mountain 01,77,962,607,0,1646
Cobb Pine Mountain 02,Pine Mountain 02,89,976,596,1,1662
Cobb Post Oak 01,Post Oak 01,85,844,656,1,1586
Cobb Pope 01,Pope 01,90,745,377,0,1212
Cobb Palmer 01,Palmer 01,91,426,407,1,925
Cobb Powder Springs 1A,Powder Springs 1A,58,495,273,0,826
Cobb Powder Springs 2A,Powder Springs 2A,31,223,93,0,347
Cobb Powder Springs 3A,Powder Springs 3A,42,343,188,0,573
Cobb Pitner 01,Pitner 01,44,328,539,2,913
Cobb Rocky Mount 01,Rocky Mount 01,54,591,690,0,1335
Cobb Riverside 01,Riverside 01,5,35,38,0,78
Cobb Roswell 01,Roswell 01,177,1131,915,0,2223
Cobb Roswell 02,Roswell 02,117,826,632,1,1576
Cobb Sandy Plains 01,Sandy Plains 01,58,514,426,1,999
Cobb Shallowford Falls 01,Shallowford Falls 01,91,686,656,0,1433
Cobb Simpson 01,Simpson 01,42,413,268,0,723
Cobb Sewell Mill 01,Sewell Mill 01,96,640,518,0,1254
Cobb Sewell Mill 03,Sewell Mill 03,118,494,470,2,1084
Cobb Smyrna 1A,Smyrna 1A,37,218,245,0,500
Cobb Smyrna 2A,Smyrna 2A,45,380,250,2,677
Cobb Smyrna 3A,Smyrna 3A,57,535,338,1,931
Cobb Smyrna 3B,Smyrna 3B,35,360,260,1,656
Cobb Smyrna 4A,Smyrna 4A,160,971,598,0,1729
Cobb Smyrna 5A,Smyrna 5A,50,368,318,0,736
Cobb Smyrna 6A,Smyrna 6A,154,929,564,2,1649
Cobb Smyrna 7A,Smyrna 7A,127,759,414,1,1301
Cobb Sope Creek 01,Sope Creek 01,88,426,416,0,930
Cobb Sope Creek 02,Sope Creek 02,128,819,668,0,1615
Cobb Sope Creek 03,Sope Creek 03,49,549,570,1,1169
Cobb Sweetwater 01,Sweetwater 01,53,391,270,0,714
Cobb Sweetwater 02,Sweetwater 02,41,164,134,0,339
Cobb Terrell Mill 01,Terrell Mill 01,52,420,394,1,867
Cobb Timber Ridge 01,Timber Ridge 01,67,466,488,0,1021
Cobb Vaughan 01,Vaughan 01,51,880,518,0,1449
Cobb Vinings 01,Vinings 01,56,313,294,1,664
Cobb Vinings 02,Vinings 02,120,759,417,2,1298
Cobb Vinings 03,Vinings 03,86,590,326,4,1006
Cobb Vinings 04,Vinings 04,138,570,608,1,1317
Cobb Wade Green 02,Wade Green 02,74,635,581,1,1291
Cobb Willeo 01,Willeo 01,79,659,440,0,1178
Coffee Douglas,Douglas,143,3617,1535,3,5298
Coffee Ambrose,Ambrose,18,427,495,1,941
Coffee Bridgetown,Bridgetown,2,51,107,0,160
Coffee Broxton,Broxton,10,513,526,0,1049
Coffee Nicholls,Nicholls,11,371,440,1,823
Coffee West Green,West Green,5,189,353,0,547
Colquitt Shaw ,Shaw ,8,226,70,0,304
Colquitt Moultrie,Moultrie,90,942,493,0,1525
Colquitt Autreyville,Autreyville,12,283,328,0,623
Colquitt Bridgecreek,Bridgecreek,15,326,326,0,667
Colquitt Crosland,Crosland,1,17,99,0,117
Colquitt Doerun,Doerun,6,69,188,0,263
Colquitt Funston,Funston,10,208,320,0,538
Colquitt Hamilton,Hamilton,8,128,281,0,417
Colquitt Hartsfield,Hartsfield,11,73,186,0,270
Colquitt Hopewell,Hopewell,16,440,350,1,807
Colquitt Lee,Lee,14,200,250,0,464
Colquitt Millcreek,Millcreek,3,87,141,0,231
Colquitt Monk,Monk,38,342,373,0,753
Colquitt Murphy,Murphy,13,323,269,0,605
Colquitt Norman Park,Norman Park,21,484,455,0,960
Colquitt Robinson,Robinson,7,130,268,0,405
Colquitt Thigpen,Thigpen,2,36,94,0,132
Colquitt TyTy,TyTy,4,45,230,0,279
Colquitt Warrior,Warrior,14,154,332,0,500
Columbia Kiokee Bapt Church,Kiokee Bapt Church,37,925,814,2,1778
Columbia Stevens Creek Church-Grovetown,Stevens Creek Church-Grovetown,12,289,261,0,562
Columbia Lewis Methodist,Lewis Methodist,42,862,699,0,1603
Columbia Woodlawn Bapt Church,Woodlawn Bapt Church,18,355,271,0,644
Columbia Patriots Park,Patriots Park,21,509,326,0,856
Columbia New Life Church,New Life Church,7,121,144,0,272
Columbia Columbia Co. Health Dept.,Columbia Co. Health Dept.,25,440,451,0,916
Columbia Harlem Branch Library,Harlem Branch Library,32,596,543,0,1171
Columbia Harlem Senior Center,Harlem Senior Center,15,263,426,0,704
Columbia Second Mount Moriah Baptist Church,Second Mount Moriah Baptist Church,12,281,343,0,636
Columbia Bessie Thomas Center,Bessie Thomas Center,6,242,210,0,458
Columbia Philadelphia Church,Philadelphia Church,19,358,357,0,734
Columbia Liberty Park-Grovetown,Liberty Park-Grovetown,20,360,438,1,819
Columbia Grovetown Methodist,Grovetown Methodist,11,187,214,0,412
Columbia G A Apostolic Church,G A Apostolic Church,24,275,349,0,648
Columbia Grovetown Dept of Public Safety Station #2,Grovetown Dept of Public Safety Station #2,18,429,340,0,787
Columbia Grove First Baptist Church,Grove First Baptist Church,13,325,270,0,608
Columbia Eubank/Blanchard Ctr,Eubank/Blanchard Ctr,13,308,407,0,728
Columbia Second Mt. Carmel Baptist Church,Second Mt. Carmel Baptist Church,9,109,141,1,260
Columbia Damascus Bapt Church,Damascus Bapt Church,12,252,455,1,720
Columbia Col Cty Board of Edu,Col Cty Board of Edu,33,555,323,0,911
Columbia Greenbrier High,Greenbrier High,48,904,798,0,1750
Columbia Parkway Baptist Church,Parkway Baptist Church,47,573,520,0,1140
Columbia Riverview Church,Riverview Church,18,342,263,0,623
Columbia Grace Baptist Church,Grace Baptist Church,27,673,689,0,1389
Columbia Christ Sanctified,Christ Sanctified,38,522,492,0,1052
Columbia Parkway Elementary,Parkway Elementary,23,580,498,0,1101
Columbia Blanchard Park,Blanchard Park,27,276,314,0,617
Columbia Belair Baptist Church,Belair Baptist Church,33,402,529,0,964
Columbia Marvin Methodist,Marvin Methodist,18,244,440,0,702
Columbia Westside Bapt Church,Westside Bapt Church,33,326,369,0,728
Columbia Trinity Bapt Church,Trinity Bapt Church,48,530,602,3,1183
Columbia Abilene Baptist,Abilene Baptist,36,334,372,0,742
Columbia Augusta Christian,Augusta Christian,43,373,415,0,831
Columbia Savannah Rapids Pavilion,Savannah Rapids Pavilion,55,557,315,0,927
Columbia Gospel Water Branch,Gospel Water Branch,18,551,462,1,1032
Columbia ACS-Furys Ferry Rd Campus,ACS-Furys Ferry Rd Campus,53,415,422,0,890
Columbia Stevens Creek Church,Stevens Creek Church,46,722,717,1,1486
Columbia Columbia Co. Fire HDQTR,Columbia Co. Fire HDQTR,11,141,236,1,389
Columbia Lakeside Middle,Lakeside Middle,16,313,295,0,624
Columbia Martinez Baptist,Martinez Baptist,22,180,373,0,575
Columbia Gold Cross EMS,Gold Cross EMS,140,377,352,1,870
Columbia Church of Our Savior,Church of Our Savior,40,312,424,0,776
Columbia West Acres Baptist,West Acres Baptist,46,537,453,0,1036
Columbia Journey Comm Church,Journey Comm Church,45,483,266,0,794
Columbia Wesley Methodist,Wesley Methodist,30,654,479,0,1163
Columbia Col Cty Main Library,Col Cty Main Library,21,566,309,1,897
Columbia Christ Church Presbyterian,Christ Church Presbyterian,22,553,448,0,1023
Columbia Blueridge Elementary,Blueridge Elementary,32,476,378,0,886
Columbia Christ The King Church,Christ The King Church,61,566,393,0,1020
Cook Cecil,Cecil,16,330,222,0,568
Cook Delle Beamguard,Delle Beamguard,45,644,366,0,1055
Cook Elm Pine,Elm Pine,1,5,10,0,16
Cook Lenox,Lenox,19,228,354,0,601
Cook Massee,Massee,9,293,153,0,455
Cook New Life Baptist Church,New Life Baptist Church,21,311,304,0,636
Cook Riverbend,Riverbend,36,397,215,0,648
Cook Sparks,Sparks,4,74,81,0,159
Coweta Senoia,Senoia,119,1620,1535,0,3274
Coweta Moreland,Moreland,58,590,956,1,1605
Coweta Pine Road,Pine Road,47,457,741,0,1245
Coweta Dresden,Dresden,7,83,372,0,462
Coweta Newnan,Newnan,37,327,340,0,704
Coweta Sharpsburg,Sharpsburg,67,1438,969,0,2474
Coweta Fischer Road,Fischer Road,90,1190,896,0,2176
Coweta Grantville,Grantville,20,235,698,0,953
Coweta Haralson,Haralson,26,407,858,0,1291
Coweta Welcome,Welcome,56,455,1039,1,1551
Coweta Panther Creek,Panther Creek,45,414,826,1,1286
Coweta Raymond,Raymond,64,606,710,0,1380
Coweta Turin,Turin,71,1427,1268,1,2767
Coweta Smokey Road,Smokey Road,32,297,415,1,745
Coweta Central,Central,40,369,262,0,671
Coweta Newnan Centre,Newnan Centre,377,4393,2270,0,7040
Coweta Greentop,Greentop,71,430,566,0,1067
Coweta Expo Center,Expo Center,42,421,493,0,956
Coweta White Oak,White Oak,66,1243,702,0,2011
Coweta Madras,Madras,247,2760,2000,2,5009
Coweta Cannongate,Cannongate,53,937,935,1,1926
Coweta Westside,Westside,10,50,74,0,134
Coweta Northside,Northside,58,404,573,0,1035
Coweta Thomas Crossroads,Thomas Crossroads,78,1477,962,1,2518
Coweta Coweta Central Library,Coweta Central Library,32,779,285,0,1096
Crawford District 1,District 1,21,284,133,1,439
Crawford District 2,District 2,29,392,300,0,721
Crawford District 3,District 3,26,411,322,0,759
Crawford District 4,District 4,38,394,509,1,942
Crawford District 5,District 5,22,293,457,0,772
Crisp Arabi,Arabi,17,151,202,0,370
Crisp Coney,Coney,22,320,261,0,603
Crisp Cordele,Cordele,142,1414,504,1,2061
Crisp Jamestown,Jamestown,23,433,327,0,783
Crisp Listonia,Listonia,16,248,215,0,479
Dade South Dade,South Dade,10,173,262,0,445
Dade New Salem,New Salem,18,256,401,1,676
Dade Davis,Davis,13,370,607,1,991
Dade New Home,New Home,4,106,223,0,333
Dade West Brow,West Brow,23,204,341,0,568
Dade Trenton,Trenton,18,693,474,1,1186
Dade North Dade,North Dade,13,363,394,0,770
Dawson West,West,83,918,600,0,1601
Dawson Central,Central,157,3724,1515,0,5396
Dawson East,East,175,3129,1708,1,5013
Decatur Mt. Pleasant,Mt. Pleasant,8,139,194,0,341
Decatur Recovery,Recovery,18,126,231,1,376
Decatur Kendrick,Kendrick,6,112,152,2,272
Decatur Climax,Climax,15,213,263,0,491
Decatur Brinson,Brinson,16,165,251,1,433
Decatur West Bainbridge,West Bainbridge,30,394,193,0,617
Decatur Bainbridge-Coliseum,Bainbridge-Coliseum,37,294,176,0,507
Decatur Bainbridge-Fairgrounds,Bainbridge-Fairgrounds,25,432,342,0,799
Decatur Attapulgus,Attapulgus,16,178,178,1,373
Decatur Kirbo Center,Kirbo Center,65,1008,377,0,1450
DeKalb Allgood Elem,Allgood Elem,9,77,86,0,172
DeKalb Ashford Park Elem,Ashford Park Elem,20,418,504,0,942
DeKalb Austin,Austin,42,642,419,1,1104
DeKalb Avondale,Avondale,39,255,323,0,617
DeKalb Austin Drive,Austin Drive,7,30,27,0,64
DeKalb Ashford Dunwoody Rd,Ashford Dunwoody Rd,47,512,478,0,1037
DeKalb Ashford Parkside,Ashford Parkside,43,528,426,0,997
DeKalb Avondale High,Avondale High,19,137,113,1,270
DeKalb Boulevard,Boulevard,10,186,117,0,313
DeKalb Briar Vista Elem,Briar Vista Elem,34,173,187,0,394
DeKalb Briarlake Elem,Briarlake Elem,39,219,248,0,506
DeKalb Briarwood,Briarwood,17,379,189,0,585
DeKalb Brockett Elem,Brockett Elem,31,324,137,0,492
DeKalb Briarcliff,Briarcliff,89,269,342,0,700
DeKalb Brockett,Brockett,28,210,248,0,486
DeKalb Brookhaven,Brookhaven,35,478,477,0,990
DeKalb Browns Mill Elem,Browns Mill Elem,13,56,41,0,110
DeKalb Bouldercrest Road,Bouldercrest Road,6,36,27,0,69
DeKalb Bethune Middle,Bethune Middle,10,53,39,0,102
DeKalb Burgess Elem,Burgess Elem,8,84,85,0,177
DeKalb Columbia Drive,Columbia Drive,3,26,26,0,55
DeKalb Canby Lane Elem,Canby Lane Elem,6,24,19,0,49
DeKalb Columbia Elem,Columbia Elem,0,5,7,0,12
DeKalb Cedar Grove Elem,Cedar Grove Elem,4,46,37,0,87
DeKalb Chamblee,Chamblee,8,310,162,0,480
DeKalb Candler-Murphey Candler Elem,Candler-Murphey Candler Elem,13,91,56,1,161
DeKalb Chapel Hill Elem,Chapel Hill Elem,5,32,38,0,75
DeKalb Chesnut Elem,Chesnut Elem,13,182,158,0,353
DeKalb Clairemont West,Clairemont West,56,184,178,0,418
DeKalb Clairmont Road,Clairmont Road,62,168,165,0,395
DeKalb Clarkston,Clarkston,3,72,80,1,156
DeKalb Clifton,Clifton,4,24,14,0,42
DeKalb Columbia Middle,Columbia Middle,1,10,29,0,40
DeKalb Coan Recreation Center,Coan Recreation Center,9,108,111,0,228
DeKalb Cross Keys High,Cross Keys High,27,215,164,0,406
DeKalb Crossroads,Crossroads,8,51,31,1,91
DeKalb Candler,Candler,3,60,47,0,110
DeKalb Cedar Grove Middle,Cedar Grove Middle,2,17,8,0,27
DeKalb Cedar Grove South,Cedar Grove South,9,43,36,0,88
DeKalb Covington Hwy,Covington Hwy,1,3,6,0,10
DeKalb Covington,Covington,6,51,59,1,117
DeKalb Clairemont East,Clairemont East,43,229,148,0,420
DeKalb Coralwood,Coralwood,68,371,260,1,700
DeKalb Candler Park,Candler Park,23,185,169,0,377
DeKalb Clarkston Community Center,Clarkston Community Center,1,60,103,0,164
DeKalb Chamblee 2,Chamblee 2,35,515,295,0,845
DeKalb Doraville North,Doraville North,28,140,210,0,378
DeKalb Doraville South,Doraville South,5,64,135,0,204
DeKalb Dresden Elem,Dresden Elem,32,367,341,0,740
DeKalb Decatur,Decatur,5,85,69,0,159
DeKalb Dunaire Elem,Dunaire Elem,13,73,66,2,154
DeKalb Dunwoody,Dunwoody,25,441,236,0,702
DeKalb Dunwoody 2,Dunwoody 2,44,525,263,0,832
DeKalb Druid Hills High,Druid Hills High,25,146,123,0,294
DeKalb Dunwoody Library,Dunwoody Library,45,759,291,0,1095
DeKalb East Lake,East Lake,11,138,123,0,272
DeKalb Embry Hills,Embry Hills,26,238,116,0,380
DeKalb Evansdale Elem,Evansdale Elem,49,365,293,1,708
DeKalb Emory South,Emory South,19,202,214,1,436
DeKalb Emory Road,Emory Road,22,68,54,0,144
DeKalb Fairington Elem,Fairington Elem,5,25,29,0,59
DeKalb Fernbank Elem,Fernbank Elem,26,187,198,0,411
DeKalb Flat Shoals Elem,Flat Shoals Elem,4,20,19,0,43
DeKalb Flat Shoals Parkway,Flat Shoals Parkway,7,37,30,0,74
DeKalb Flat Rock Elem,Flat Rock Elem,3,35,40,0,78
DeKalb Flat Shoals,Flat Shoals,3,18,15,0,36
DeKalb Flakes Mill,Flakes Mill,3,23,7,0,33
DeKalb Flat Shoals Library,Flat Shoals Library,0,32,13,0,45
DeKalb Freedom Middle,Freedom Middle,13,77,63,0,153
DeKalb Glennwood,Glennwood,28,98,104,0,230
DeKalb Glenhaven,Glenhaven,7,41,47,0,95
DeKalb Gresham Road,Gresham Road,3,63,35,1,102
DeKalb Georgetown Sq,Georgetown Sq,33,434,253,0,720
DeKalb Glenwood Road,Glenwood Road,13,23,47,0,83
DeKalb Hambrick Elem,Hambrick Elem,17,114,122,1,254
DeKalb Hawthorne Elem,Hawthorne Elem,35,252,272,0,559
DeKalb Henderson Mill,Henderson Mill,55,365,239,0,659
DeKalb Huntley Hills Elem,Huntley Hills Elem,25,267,246,1,539
DeKalb Hugh Howell,Hugh Howell,27,269,208,0,504
DeKalb Harris-Narvie J Harris Elem,Harris-Narvie J Harris Elem,4,49,31,0,84
DeKalb Harris-Margaret Harris ED,Harris-Margaret Harris ED,6,60,88,0,154
DeKalb Idlewood Elem,Idlewood Elem,19,109,134,0,262
DeKalb Indian Creek,Indian Creek,6,74,53,1,134
DeKalb Johnson Estates,Johnson Estates,29,155,142,0,326
DeKalb Jolly Elem,Jolly Elem,33,140,156,1,330
DeKalb Kelley Lake Elem,Kelley Lake Elem,7,34,31,0,72
DeKalb Kingsley Elem,Kingsley Elem,75,611,367,0,1053
DeKalb Kelley Chapel Road,Kelley Chapel Road,3,16,23,0,42
DeKalb Knollwood,Knollwood,1,27,54,0,82
DeKalb Kittredge Elem,Kittredge Elem,43,478,272,0,793
DeKalb Lakeside High,Lakeside High,70,361,383,1,815
DeKalb Lavista Road,Lavista Road,56,180,205,0,441
DeKalb Lavista,Lavista,34,189,207,1,431
DeKalb Lithonia,Lithonia,0,23,31,0,54
DeKalb Lin-Mary Lin Elem,Lin-Mary Lin Elem,25,171,142,0,338
DeKalb Lithonia High,Lithonia High,0,27,35,0,62
DeKalb Livsey Elem,Livsey Elem,20,222,138,0,380
DeKalb Miller-Eldridge L Miller Elem,Miller-Eldridge L Miller Elem,7,41,44,0,92
DeKalb McNair High,McNair High,13,69,65,0,147
DeKalb Marbut Elem,Marbut Elem,4,28,34,0,66
DeKalb McNair,McNair,5,33,38,0,76
DeKalb McLendon,McLendon,22,175,159,0,356
DeKalb McWilliams,McWilliams,4,30,12,0,46
DeKalb Medlock,Medlock,26,153,145,0,324
DeKalb Midvale Elem,Midvale Elem,60,490,319,0,869
DeKalb Miller Grove,Miller Grove,3,27,16,0,46
DeKalb Montclair Elem,Montclair Elem,4,48,56,0,108
DeKalb Montreal,Montreal,12,132,157,0,301
DeKalb Meadowview,Meadowview,8,28,30,0,66
DeKalb Memorial South,Memorial South,3,55,63,0,121
DeKalb Midway,Midway,14,59,31,0,104
DeKalb McNair Academy,McNair Academy,5,21,26,0,52
DeKalb Mount Vernon East,Mount Vernon East,42,647,420,0,1109
DeKalb Mathis-Bob Mathis Elem,Mathis-Bob Mathis Elem,8,43,17,0,68
DeKalb Mount Vernon West,Mount Vernon West,28,503,242,0,773
DeKalb Metropolitan,Metropolitan,4,90,88,0,182
DeKalb Montgomery Elem,Montgomery Elem,47,391,366,0,804
DeKalb Miller Grove Road,Miller Grove Road,5,32,26,0,63
DeKalb Midvale Road,Midvale Road,16,104,77,0,197
DeKalb Miller Grove High,Miller Grove High,0,29,23,0,52
DeKalb North Decatur,North Decatur,27,66,61,0,154
DeKalb North Hairston,North Hairston,7,74,54,0,135
DeKalb Northlake,Northlake,28,130,179,0,337
DeKalb North Peachtree,North Peachtree,13,155,155,0,323
DeKalb Oak Grove Elem,Oak Grove Elem,30,235,277,0,542
DeKalb Oakcliff Elem,Oakcliff Elem,21,94,163,1,279
DeKalb Oakhurst,Oakhurst,6,79,127,0,212
DeKalb Oak View Elem,Oak View Elem,8,32,33,0,73
DeKalb Peachcrest,Peachcrest,3,48,50,1,102
DeKalb Peachtree Middle,Peachtree Middle,41,324,166,0,531
DeKalb Princeton Elem,Princeton Elem,3,37,25,0,65
DeKalb Pine Lake,Pine Lake,1,6,44,0,51
DeKalb Pleasantdale Road,Pleasantdale Road,22,171,128,0,321
DeKalb Ponce de Leon,Ponce de Leon,17,105,136,0,258
DeKalb Panola,Panola,5,24,25,0,54
DeKalb Panola Way Elem,Panola Way Elem,2,19,16,0,37
DeKalb Piney Grove,Piney Grove,3,26,31,0,60
DeKalb Panola Road,Panola Road,3,27,24,0,54
DeKalb Rainbow Elem,Rainbow Elem,5,58,31,1,95
DeKalb Redan Elem,Redan Elem,4,45,22,0,71
DeKalb Rehoboth,Rehoboth,34,198,168,0,400
DeKalb Rockbridge Elem,Rockbridge Elem,13,49,64,0,126
DeKalb Rock Chapel Elem,Rock Chapel Elem,4,41,33,0,78
DeKalb Rowland Elem,Rowland Elem,3,44,55,0,102
DeKalb Redan-Trotti Library,Redan-Trotti Library,8,47,18,0,73
DeKalb Rockbridge Road,Rockbridge Road,10,53,62,0,125
DeKalb Rowland Road,Rowland Road,11,35,51,0,97
DeKalb Redan Road,Redan Road,3,36,29,0,68
DeKalb Rock Chapel Road,Rock Chapel Road,25,95,74,0,194
DeKalb Redan Middle,Redan Middle,11,39,38,1,89
DeKalb Sagamore Hills Elem,Sagamore Hills Elem,62,383,326,0,771
DeKalb Scott,Scott,28,154,138,0,320
DeKalb Shaw-Robert Shaw Elem,Shaw-Robert Shaw Elem,11,72,85,0,168
DeKalb Stone Mountain Elem,Stone Mountain Elem,143,151,75,0,369
DeKalb Silver Lake,Silver Lake,60,837,488,0,1385
DeKalb Skyland,Skyland,14,376,320,1,711
DeKalb Snapfinger Elem,Snapfinger Elem,7,17,25,0,49
DeKalb Smoke Rise,Smoke Rise,66,315,221,1,603
DeKalb Stone Mtn Middle,Stone Mtn Middle,9,43,55,0,107
DeKalb Stone Mill Elem,Stone Mill Elem,7,43,37,0,87
DeKalb Shadow Rock Elem,Shadow Rock Elem,12,81,40,0,133
DeKalb Stoneview Elem,Stoneview Elem,6,21,21,0,48
DeKalb Salem Middle,Salem Middle,3,39,45,0,87
DeKalb Shamrock,Shamrock,33,139,112,0,284
DeKalb South Deshon,South Deshon,4,34,32,0,70
DeKalb Stone Mtn Champion,Stone Mtn Champion,6,56,75,0,137
DeKalb Stone Mtn,Stone Mtn,3,75,62,0,140
DeKalb Snapfinger Road N,Snapfinger Road N,13,32,17,0,62
DeKalb Snapfinger Road S,Snapfinger Road S,5,19,27,0,51
DeKalb Stephenson Middle,Stephenson Middle,6,64,61,0,131
DeKalb South Hairston,South Hairston,2,41,38,0,81
DeKalb Stephenson High,Stephenson High,7,83,52,0,142
DeKalb Stonecrest Library,Stonecrest Library,3,46,28,0,77
DeKalb Snapfinger Road,Snapfinger Road,7,82,33,1,123
DeKalb Terry Mill,Terry Mill,7,42,43,0,92
DeKalb Toney Elem,Toney Elem,5,16,21,0,42
DeKalb Tucker Library,Tucker Library,60,541,231,0,832
DeKalb Tilly Mill Road,Tilly Mill Road,26,289,257,0,572
DeKalb Tucker,Tucker,32,393,175,0,600
DeKalb Valley Brook,Valley Brook,9,44,66,0,119
DeKalb Wadsworth,Wadsworth,7,38,19,0,64
DeKalb Wesley Chapel Library,Wesley Chapel Library,5,43,23,0,71
DeKalb Woodrow Road,Woodrow Road,14,39,35,0,88
DeKalb Winnona Park,Winnona Park,21,84,108,0,213
DeKalb Woodridge Elem,Woodridge Elem,11,60,39,0,110
DeKalb Warren Tech,Warren Tech,12,67,141,0,220
DeKalb Woodward,Woodward,46,265,155,0,466
DeKalb White Oak,White Oak,0,19,24,0,43
DeKalb Winters Chapel,Winters Chapel,20,241,225,2,488
DeKalb Wynbrooke Elem,Wynbrooke Elem,11,82,36,0,129
DeKalb Young Road,Young Road,1,34,13,0,48
Dodge Chauncey,Chauncey,7,57,145,0,209
Dodge Clark,Clark,3,13,44,0,60
Dodge Eddin,Eddin,16,212,237,0,465
Dodge Empire,Empire,7,91,140,0,238
Dodge Jaybird,Jaybird,6,18,60,0,84
Dodge Jones,Jones,6,87,146,0,239
Dodge Lee,Lee,97,1069,492,1,1659
Dodge McCranie,McCranie,8,56,121,0,185
Dodge Milan,Milan,4,43,125,0,172
Dodge Mitchell,Mitchell,3,59,134,0,196
Dodge Mullis,Mullis,5,56,196,0,257
Dodge Plainfield,Plainfield,6,101,164,0,271
Dodge Pondtown,Pondtown,21,116,233,0,370
Dodge Rawlins,Rawlins,16,209,177,0,402
Dodge Vilula,Vilula,2,28,101,0,131
Dodge Yonker,Yonker,1,20,128,0,149
Dooly Lilly,Lilly,2,60,92,0,154
Dooly Byromville,Byromville,7,58,136,0,201
Dooly Unadilla,Unadilla,19,220,241,0,480
Dooly Vienna,Vienna,27,541,209,0,777
Dooly Pinehurst,Pinehurst,10,103,135,0,248
Dougherty Sherwood Elementary School,Sherwood Elementary School,30,144,351,0,525
Dougherty Covenant Church,Covenant Church,15,146,318,0,479
Dougherty Greenbriar Church,Greenbriar Church,63,596,592,0,1251
Dougherty Westover High School,Westover High School,88,661,613,0,1362
Dougherty Merry Acres Middle,Merry Acres Middle,31,236,412,0,679
Dougherty ASU West Campus,ASU West Campus,25,180,209,0,414
Dougherty Westown Elementary School,Westown Elementary School,4,34,34,0,72
Dougherty 2nd Mt. Zion Church,2nd Mt. Zion Church,20,98,328,0,446
Dougherty Mt. Zion Center ,Mt. Zion Center ,2,11,29,0,42
Dougherty Alice Coachman Elementary,Alice Coachman Elementary,0,0,10,0,10
Dougherty Driskell Community Center,Driskell Community Center,2,4,10,0,16
Dougherty Shiloh Baptist Church,Shiloh Baptist Church,3,8,6,0,17
Dougherty Litman Cathedral,Litman Cathedral,3,7,12,0,22
Dougherty Phoebe Healthworks,Phoebe Healthworks,28,312,393,2,735
Dougherty Turner Elementary School,Turner Elementary School,1,3,7,0,11
Dougherty Robert H. Harvey Elementary,Robert H. Harvey Elementary,0,6,12,0,18
Dougherty Bill Miller Community Center,Bill Miller Community Center,2,22,45,0,69
Dougherty Radium Middle School,Radium Middle School,8,26,66,0,100
Dougherty Putney 1st Baptist Church,Putney 1st Baptist Church,14,129,515,0,658
Dougherty International Studies,International Studies,9,51,119,2,181
Dougherty Phoebe East ,Phoebe East ,7,28,84,0,119
Dougherty Pine Bluff Baptist Church,Pine Bluff Baptist Church,15,83,233,0,331
Dougherty Albany Middle School,Albany Middle School,6,13,34,0,53
Dougherty Christ Church,Christ Church,29,249,586,0,864
Dougherty Lamar Reese Elementary School,Lamar Reese Elementary School,2,6,33,0,41
Dougherty ASU East Campus - Lovett Hall ,ASU East Campus - Lovett Hall ,0,3,6,0,9
Douglas Mirror Lake Elementary,Mirror Lake Elementary,65,828,637,0,1530
Douglas Winston,Winston,19,235,164,0,418
Douglas Dog River Library,Dog River Library,77,1736,582,0,2395
Douglas Atlanta West Pentecostal,Atlanta West Pentecostal,7,76,76,0,159
Douglas Ephesus Baptist Church,Ephesus Baptist Church,49,1105,764,0,1918
Douglas Prays Mill Gym,Prays Mill Gym,68,1142,522,0,1732
Douglas Turner,Turner,60,443,273,1,777
Douglas First Baptist Lithia Springs,First Baptist Lithia Springs,18,263,162,0,443
Douglas Lithia Springs High School,Lithia Springs High School,25,352,132,0,509
Douglas Deer Lick,Deer Lick,19,382,145,0,546
Douglas Golden Methodist Church,Golden Methodist Church,20,186,114,0,320
Douglas Old Courthouse,Old Courthouse,45,552,184,0,781
Douglas Beulah Baptist Church,Beulah Baptist Church,49,507,318,0,874
Douglas Stewart,Stewart,5,141,48,0,194
Douglas Arbor Station,Arbor Station,24,232,201,0,457
Douglas Bright Star,Bright Star,19,395,355,0,769
Douglas Dorsett Shoals,Dorsett Shoals,47,572,341,0,960
Douglas Chapel Hill,Chapel Hill,16,356,184,0,556
Douglas Church At Chapel Hill,Church At Chapel Hill,34,654,293,0,981
Douglas Chestnut Log,Chestnut Log,29,336,160,0,525
Douglas St Julians Episcopal,St Julians Episcopal,28,277,237,0,542
Douglas Lutheran Church-GS,Lutheran Church-GS,26,493,289,1,809
Douglas First Baptist Douglasville,First Baptist Douglasville,37,361,177,0,575
Douglas Factory Shoals,Factory Shoals,29,401,201,0,631
Douglas Boundary Waters,Boundary Waters,16,218,84,0,318
Early Arlington ,Arlington ,14,104,144,0,262
Early Blakely,Blakely,31,491,167,3,692
Early Cedar Springs ,Cedar Springs ,9,196,310,1,516
Early Cuba,Cuba,14,238,230,0,482
Early Urquhart,Urquhart,17,212,140,0,369
Echols Statenville,Statenville,31,583,341,1,956
Effingham 1A,1A,26,535,691,2,1254
Effingham 1B,1B,17,589,618,1,1225
Effingham 1C,1C,7,241,603,2,853
Effingham 1D,1D,23,257,704,0,984
Effingham 2A,2A,21,323,666,0,1010
Effingham 2B,2B,20,323,420,0,763
Effingham 2C,2C,30,513,508,1,1052
Effingham 2D,2D,34,631,707,1,1373
Effingham 3A,3A,12,268,384,0,664
Effingham 3B,3B,32,531,481,0,1044
Effingham 3C,3C,20,305,266,0,591
Effingham 3D,3D,17,660,575,0,1252
Effingham 3E,3E,12,322,226,0,560
Effingham 4A,4A,37,937,582,0,1556
Effingham 4B,4B,19,368,347,1,735
Effingham 4C,4C,23,562,367,0,952
Effingham 5A,5A,38,588,641,0,1267
Effingham 5B,5B,25,399,403,0,827
Effingham 5C,5C,16,445,399,0,860
Effingham 5D,5D,6,364,361,0,731
Elbert Elberton,Elberton,62,733,318,0,1113
Elbert Longstreet,Longstreet,11,165,168,1,345
Elbert Eliam,Eliam,20,184,214,1,419
Elbert Petersburg,Petersburg,4,77,152,0,233
Elbert Wyche,Wyche,24,314,219,1,558
Elbert Moss-Ruckersville,Moss-Ruckersville,10,105,100,0,215
Elbert Pike,Pike,20,287,320,2,629
Elbert Gaines,Gaines,8,98,248,0,354
Elbert Goshen,Goshen,15,292,511,1,819
Elbert Webbsboro,Webbsboro,2,93,108,0,203
Elbert Centerville,Centerville,16,202,262,1,481
Emanuel Adrian,Adrian,12,119,245,1,377
Emanuel Blundale,Blundale,7,176,308,1,492
Emanuel Canoochee,Canoochee,6,121,240,0,367
Emanuel Cross-Green,Cross-Green,3,8,46,0,57
Emanuel Garfiled,Garfiled,3,53,212,0,268
Emanuel Nunez,Nunez,4,63,129,0,196
Emanuel Oak Park,Oak Park,6,70,286,0,362
Emanuel Stillmore,Stillmore,2,64,159,0,225
Emanuel Summerton,Summerton,1,55,167,0,223
Emanuel Swainsboro,Swainsboro,109,1306,877,4,2296
Emanuel Twin City,Twin City,23,217,401,1,642
Evans Veterans Community Center,Veterans Community Center,148,1516,803,0,2467
Fannin Colwell,Colwell,37,272,341,0,650
Fannin Fairplay,Fairplay,30,272,328,0,630
Fannin Flinthill,Flinthill,83,613,845,2,1543
Fannin Hemptown,Hemptown,31,291,432,0,754
Fannin Hothouse,Hothouse,42,294,330,3,669
Fannin Mineral Bluff,Mineral Bluff,61,579,459,1,1100
Fannin Mobile,Mobile,33,198,392,0,623
Fannin Morganton,Morganton,69,460,605,2,1136
Fannin Noontootla,Noontootla,20,218,269,1,508
Fannin Skeniah,Skeniah,9,58,128,0,195
Fannin Sugar Creek,Sugar Creek,90,682,507,2,1281
Fannin Toccoa,Toccoa,114,923,623,3,1663
Fayette Blackrock,Blackrock,39,296,157,0,492
Fayette Brooks,Brooks,51,684,912,0,1647
Fayette Europe,Europe,24,160,88,0,272
Fayette Fayetteville East,Fayetteville East,33,313,140,1,487
Fayette Fayetteville West,Fayetteville West,39,309,173,1,522
Fayette Flint,Flint,11,206,160,0,377
Fayette Hopeful,Hopeful,22,301,199,1,523
Fayette Morning Creek,Morning Creek,52,484,229,0,765
Fayette Rareover,Rareover,37,985,338,0,1360
Fayette Sandy Creek,Sandy Creek,26,828,342,1,1197
Fayette Shakerag East,Shakerag East,16,338,329,2,685
Fayette Shakerag West,Shakerag West,14,425,163,0,602
Fayette Starrs Mill,Starrs Mill,84,1003,675,0,1762
Fayette Whitewater,Whitewater,82,1089,600,0,1771
Fayette Woolsey,Woolsey,71,712,648,0,1431
Fayette McIntosh,McIntosh,58,997,463,0,1518
Fayette Oak Grove,Oak Grove,12,296,278,0,586
Fayette Kedron,Kedron,61,1349,696,2,2108
Fayette Aberdeen,Aberdeen,19,492,294,0,805
Fayette Windgate,Windgate,10,244,227,2,483
Fayette Flat Creek,Flat Creek,59,456,288,0,803
Fayette Braelinn,Braelinn,29,586,407,0,1022
Fayette Kenwood,Kenwood,13,64,67,0,144
Fayette Banks,Banks,38,252,170,0,460
Fayette Harps Crossing,Harps Crossing,32,339,333,0,704
Fayette Willow Pond,Willow Pond,51,605,368,0,1024
Fayette Dogwood,Dogwood,52,960,467,0,1479
Fayette Oak Ridge,Oak Ridge,27,311,233,0,571
Fayette Jeff Davis,Jeff Davis,53,330,145,0,528
Fayette Murphy,Murphy,54,638,349,0,1041
Fayette Fielding Ridge,Fielding Ridge,41,966,502,0,1509
Fayette Willowbend,Willowbend,25,524,302,0,851
Fayette Camp Creek,Camp Creek,26,559,343,1,929
Fayette Rising Star,Rising Star,59,1257,713,0,2029
Fayette Spring Hill,Spring Hill,48,562,261,0,871
Fayette Antioch,Antioch,28,351,379,0,758
Floyd Alto Park,Alto Park,59,874,593,3,1529
Floyd Armuchee,Armuchee,17,225,447,0,689
Floyd Barkers,Barkers,24,554,613,0,1191
Floyd Cave Spring,Cave Spring,8,134,579,3,724
Floyd Chulio,Chulio,15,196,392,2,605
Floyd Etowah,Etowah,88,1385,979,5,2457
Floyd Everett Springs,Everett Springs,0,41,187,0,228
Floyd Floyd Springs,Floyd Springs,31,289,644,2,966
Floyd Fosters Mill,Fosters Mill,10,152,377,0,539
Floyd Garden Lakes,Garden Lakes,25,425,275,0,725
Floyd Glenwood,Glenwood,55,558,785,0,1398
Floyd Howell,Howell,18,246,593,0,857
Floyd East Lindale,East Lindale,33,690,719,2,1444
Floyd Mt Alto North,Mt Alto North,85,882,441,0,1408
Floyd Mt Alto South,Mt Alto South,61,600,518,1,1180
Floyd North Carolina,North Carolina,28,346,449,0,823
Floyd Riverside,Riverside,8,117,236,0,361
Floyd East Rome,East Rome,35,727,426,3,1191
Floyd North Rome,North Rome,54,578,330,0,962
Floyd South Rome,South Rome,11,89,59,0,159
Floyd Texas Valley,Texas Valley,6,98,313,0,417
Floyd Vanns Valley,Vanns Valley,13,108,199,0,320
Floyd Watters,Watters,59,718,907,7,1691
Floyd West Lindale,West Lindale,43,463,632,1,1139
Floyd Town Rome,Town Rome,42,532,353,0,927
Forsyth 01 Big Creek,01 Big Creek,148,2183,1112,1,3444
Forsyth 02 Brandywine,02 Brandywine,47,452,740,0,1239
Forsyth 04 Chestatee,04 Chestatee,81,1403,787,4,2275
Forsyth 05 Coal Mountain,05 Coal Mountain,102,2096,1181,1,3380
Forsyth 06 Crossroads,06 Crossroads,87,2288,1064,0,3439
Forsyth 07 Cumming,07 Cumming,159,2066,767,5,2997
Forsyth 08 Mashburn,08 Mashburn,171,1852,885,1,2909
Forsyth 10 Midway,10 Midway,176,3456,1272,1,4905
Forsyth 15 Heardsville,15 Heardsville,115,1877,1051,3,3046
Forsyth 16 Otwell,16 Otwell,170,2745,1054,4,3973
Forsyth 19 Old Atlanta,19 Old Atlanta,66,701,802,2,1571
Forsyth 21 South Forsyth,21 South Forsyth,41,746,323,0,1110
Forsyth 25 Windermere,25 Windermere,114,1613,1287,2,3016
Forsyth 27 Concord,27 Concord,149,3644,1820,3,5616
Forsyth 34 Fowler,34 Fowler,114,1769,825,0,2708
Forsyth 35 Johns Creek,35 Johns Creek,137,1527,809,3,2476
Forsyth 36 Nichols,36 Nichols,86,1800,939,0,2825
Forsyth 38 Daves Creek,38 Daves Creek,146,2155,893,3,3197
Forsyth 39 Mathis,39 Mathis,103,1362,552,2,2019
Forsyth 40 West Forsyth,40 West Forsyth,96,2181,1029,8,3314
Forsyth 41 Grassland,41 Grassland,42,850,433,4,1329
Forsyth 42 Keith Bridge,42 Keith Bridge,70,1264,748,2,2084
Forsyth 43 Lakeland,43 Lakeland,140,1180,676,0,1996
Forsyth 44 Lanier,44 Lanier,101,1366,744,2,2213
Forsyth 45 Mountainside,45 Mountainside,79,1715,801,1,2596
Forsyth 46 Sawmill Branch,46 Sawmill Branch,54,1132,609,0,1795
Forsyth 47 Riverclub,47 Riverclub,28,534,663,1,1226
Forsyth 49 Cheatam Creek,49 Cheatam Creek,62,958,397,1,1418
Franklin Carnesville,Carnesville,39,755,556,0,1350
Franklin West Franklin,West Franklin,27,457,438,0,922
Franklin Northeast Franklin,Northeast Franklin,84,650,770,0,1504
Franklin Lavonia,Lavonia,33,486,514,0,1033
Franklin Canon,Canon,16,272,366,0,654
Franklin Royston,Royston,47,420,447,0,914
Franklin Southwest Franklin,Southwest Franklin,45,635,677,0,1357
Fulton 01A,01A,8,130,115,0,253
Fulton 01B,01B,13,114,228,0,355
Fulton 01C,01C,0,13,18,0,31
Fulton 01D,01D,1,31,27,1,60
Fulton 01E,01E,20,139,144,0,303
Fulton 01F,01F,0,11,7,1,19
Fulton 01G,01G,5,30,65,1,101
Fulton 01H,01H,1,6,8,0,15
Fulton 01I,01I,0,0,0,0,0
Fulton 01J,01J,8,24,18,0,50
Fulton 01P,01P,0,3,14,0,17
Fulton 01R,01R,0,1,13,0,14
Fulton 01S,01S,4,14,31,0,49
Fulton 01T,01T,4,33,34,0,71
Fulton 02A,02A,19,270,130,2,421
Fulton 02A1,02A1,12,152,74,0,238
Fulton 02B,02B,5,57,61,0,123
Fulton 02C,02C,6,40,41,0,87
Fulton 02D,02D,13,179,198,2,392
Fulton 02E,02E,5,52,96,0,153
Fulton 02F1,02F1,6,157,118,0,281
Fulton 02F2,02F2,2,30,24,0,56
Fulton 02G,02G,13,192,163,0,368
Fulton 02J,02J,13,71,71,1,156
Fulton 02K,02K,5,71,68,1,145
Fulton 02L1,02L1,18,281,184,0,483
Fulton 02L1A,02L1A,15,76,91,1,183
Fulton 02L2,02L2,6,119,89,0,214
Fulton 02S,02S,1,17,17,0,35
Fulton 02W,02W,4,38,20,0,62
Fulton 03A,03A,1,17,18,1,37
Fulton 03B,03B,0,7,2,0,9
Fulton 03C,03C,2,16,15,1,34
Fulton 03D,03D,0,7,9,0,16
Fulton 03E,03E,0,17,29,0,46
Fulton 03F,03F,10,81,81,0,172
Fulton 03G,03G,0,6,11,0,17
Fulton 03H,03H,1,9,11,0,21
Fulton 03I,03I,1,41,23,0,65
Fulton 03L,03L,0,5,10,0,15
Fulton 03M,03M,2,30,79,0,111
Fulton 03N,03N,3,11,24,0,38
Fulton 03P1A,03P1A,12,118,131,2,263
Fulton 03P1B,03P1B,0,0,0,0,0
Fulton 03P2,03P2,0,0,1,0,1
Fulton 03S,03S,1,6,12,0,19
Fulton 03T,03T,0,15,18,0,33
Fulton 04A,04A,1,10,9,1,21
Fulton 04B,04B,3,15,19,0,37
Fulton 04C,04C,0,0,0,0,0
Fulton 04D,04D,2,20,30,0,52
Fulton 04F,04F,4,56,44,0,104
Fulton 04G,04G,1,9,9,0,19
Fulton 04I,04I,4,14,18,0,36
Fulton 04J,04J,0,2,5,0,7
Fulton 04K,04K,2,14,17,0,33
Fulton 04L,04L,2,23,21,0,46
Fulton 04M,04M,2,1,7,0,10
Fulton 04S,04S,3,18,24,0,45
Fulton 04T,04T,0,14,8,0,22
Fulton 04V,04V,0,12,27,0,39
Fulton 04W,04W,0,1,1,0,2
Fulton 04X1,04X1,0,34,24,0,58
Fulton 04X2,04X2,0,7,12,0,19
Fulton 05A1,05A1,9,98,113,0,220
Fulton 05A2,05A2,7,120,93,1,221
Fulton 05B,05B,3,27,19,0,49
Fulton 05C,05C,1,0,0,0,1
Fulton 05D,05D,1,3,2,0,6
Fulton 05F,05F,0,1,2,0,3
Fulton 05J,05J,6,17,18,0,41
Fulton 05K,05K,2,35,20,0,57
Fulton 06B,06B,10,117,95,0,222
Fulton 06D,06D,29,178,153,1,361
Fulton 06D1,06D1,42,359,237,0,638
Fulton 06D2,06D2,25,232,151,1,409
Fulton 06E,06E,16,120,120,2,258
Fulton 06F,06F,8,214,107,0,329
Fulton 06G,06G,5,29,25,0,59
Fulton 06I,06I,5,80,82,0,167
Fulton 06J,06J,17,194,147,2,360
Fulton 06L1,06L1,19,148,61,0,228
Fulton 06L2,06L2,5,115,73,0,193
Fulton 06N,06N,18,268,128,0,414
Fulton 06Q,06Q,1,13,8,0,22
Fulton 06R,06R,17,192,67,1,277
Fulton 07A,07A,22,535,258,0,815
Fulton 07A1,07A1,67,595,287,2,951
Fulton 07B,07B,40,845,459,2,1346
Fulton 07C,07C,182,658,292,2,1134
Fulton 07D,07D,21,366,186,0,573
Fulton 07D1,07D1,13,223,140,0,376
Fulton 07E,07E,40,302,133,1,476
Fulton 07F,07F,33,610,362,2,1007
Fulton 07H,07H,31,438,192,0,661
Fulton 07J,07J,35,462,294,0,791
Fulton 07M,07M,19,179,120,1,319
Fulton 07N,07N,8,71,55,0,134
Fulton 08A,08A,48,723,258,1,1030
Fulton 08B,08B,38,1032,331,1,1402
Fulton 08C,08C,1,108,18,0,127
Fulton 08C1,08C1,22,453,116,1,592
Fulton 08D,08D,19,428,96,0,543
Fulton 08E,08E,52,822,274,0,1148
Fulton 08F1,08F1,28,763,247,0,1038
Fulton 08F2,08F2,0,0,0,0,0
Fulton 08G,08G,61,448,156,0,665
Fulton 08H,08H,52,830,234,2,1118
Fulton 08J,08J,30,680,361,3,1074
Fulton 08K,08K,3,148,129,0,280
Fulton 08L,08L,33,493,305,1,832
Fulton 08M,08M,25,637,323,2,987
Fulton 08N1,08N1,10,284,79,0,373
Fulton 08N2,08N2,41,316,103,0,460
Fulton 08P,08P,4,93,75,0,172
Fulton 09A,09A,21,348,249,1,619
Fulton 09B,09B,0,3,1,0,4
Fulton 09C,09C,4,30,28,0,62
Fulton 09D,09D,0,19,13,0,32
Fulton 09E,09E,4,70,46,0,120
Fulton 09F,09F,34,701,328,1,1064
Fulton 09G,09G,20,264,222,0,506
Fulton 09H,09H,3,43,36,0,82
Fulton 09I,09I,1,21,15,0,37
Fulton 09K,09K,1,23,20,0,44
Fulton 09K1,09K1,4,38,17,0,59
Fulton 09M,09M,3,212,123,0,338
Fulton 10A,10A,1,25,29,0,55
Fulton 10B,10B,6,56,32,0,94
Fulton 10C,10C,0,12,13,1,26
Fulton 10D,10D,0,3,3,0,6
Fulton 10D2,10D2,0,12,6,0,18
Fulton 10D1,10D1,2,21,11,0,34
Fulton 10E,10E,0,12,9,1,22
Fulton 10F,10F,1,14,13,0,28
Fulton 10G,10G,4,16,17,0,37
Fulton 10H1,10H1,0,1,4,0,5
Fulton 10H2,10H2,4,17,15,1,37
Fulton 10I,10I,0,2,4,0,6
Fulton 10J,10J,3,3,15,0,21
Fulton 10K,10K,1,30,14,1,46
Fulton 10M,10M,3,29,43,0,75
Fulton 10P,10P,1,13,13,0,27
Fulton 10R,10R,0,4,7,1,12
Fulton 11B,11B,1,28,14,1,44
Fulton 11B2,11B2,0,0,2,0,2
Fulton 11B1,11B1,2,16,12,0,30
Fulton 11C,11C,0,9,5,0,14
Fulton 11C2,11C2,0,29,13,0,42
Fulton 11C3,11C3,0,13,5,0,18
Fulton 11E1,11E1,0,14,16,0,30
Fulton 11E2,11E2,0,4,10,0,14
Fulton 11E3,11E3,1,25,24,0,50
Fulton 11G,11G,1,28,7,0,36
Fulton 11H,11H,3,10,11,0,24
Fulton 11J,11J,2,27,12,1,42
Fulton 11K,11K,0,35,13,0,48
Fulton 11M,11M,2,23,8,0,33
Fulton 11M1,11M1,0,18,11,0,29
Fulton 11N,11N,6,25,22,0,53
Fulton 11P,11P,1,10,13,0,24
Fulton 11R,11R,0,9,7,0,16
Fulton 12A,12A,1,34,29,0,64
Fulton 12A1,12A1,5,47,54,0,106
Fulton 12D,12D,0,12,12,0,24
Fulton 12E1,12E1,4,14,9,0,27
Fulton 12E2,12E2,0,0,0,0,0
Fulton 12F,12F,2,7,9,0,18
Fulton 12G,12G,0,6,8,0,14
Fulton 12H1,12H1,1,7,5,0,13
Fulton 12H2,12H2,2,11,26,1,40
Fulton 12I,12I,0,8,3,0,11
Fulton 12J,12J,5,17,24,0,46
Fulton 12K,12K,0,40,32,1,73
Fulton 12L,12L,1,4,3,0,8
Fulton 12M,12M,2,21,19,0,42
Fulton 12N,12N,4,5,5,0,14
Fulton 12S,12S,0,16,10,1,27
Fulton AP01A,AP01A,77,1129,469,3,1678
Fulton AP01B,AP01B,21,256,104,0,381
Fulton AP01C,AP01C,23,584,197,1,805
Fulton AP01D,AP01D,14,140,98,0,252
Fulton AP01E,AP01E,0,0,0,0,0
Fulton AP021,AP021,27,783,354,1,1165
Fulton AP022,AP022,25,336,198,0,559
Fulton AP023,AP023,16,139,59,0,214
Fulton AP02B,AP02B,25,123,58,0,206
Fulton AP03,AP03,1,40,31,0,72
Fulton AP04A,AP04A,26,461,226,1,714
Fulton AP04B,AP04B,6,121,45,0,172
Fulton AP05,AP05,70,1097,535,0,1702
Fulton AP06,AP06,21,540,258,0,819
Fulton AP07A,AP07A,56,796,403,1,1256
Fulton AP07C,AP07C,12,287,116,0,415
Fulton AP07B,AP07B,7,167,91,0,265
Fulton AP09A,AP09A,62,881,401,1,1345
Fulton AP09B,AP09B,5,145,67,0,217
Fulton AP10,AP10,9,282,124,0,415
Fulton AP12A,AP12A,5,67,67,0,139
Fulton AP12B,AP12B,27,109,91,1,228
Fulton AP12C,AP12C,33,637,231,1,902
Fulton AP12D,AP12D,0,0,0,0,0
Fulton AP14,AP14,1,18,7,0,26
Fulton AP14A,AP14A,35,771,267,1,1074
Fulton CH01,CH01,1,31,13,0,45
Fulton CH02,CH02,3,75,50,1,129
Fulton CH03,CH03,3,81,81,4,169
Fulton CH04A,CH04A,4,209,91,3,307
Fulton CH04B,CH04B,0,1,0,0,1
Fulton CH05,CH05,0,118,73,0,191
Fulton CP011,CP011,7,73,33,0,113
Fulton CP012,CP012,3,91,33,0,127
Fulton CP01B,CP01B,0,56,17,0,73
Fulton CP02,CP02,5,47,26,0,78
Fulton CP04A,CP04A,0,1,0,0,1
Fulton CP04B,CP04B,0,0,1,0,1
Fulton CP051,CP051,0,0,1,0,1
Fulton CP05C,CP05C,2,20,13,0,35
Fulton CP052,CP052,0,0,0,0,0
Fulton CP05B,CP05B,1,4,0,0,5
Fulton CP06A,CP06A,0,3,4,0,7
Fulton CP06B,CP06B,0,0,0,0,0
Fulton CP07A,CP07A,1,3,4,1,9
Fulton CP07B,CP07B,0,0,0,0,0
Fulton CP07C,CP07C,0,1,0,0,1
Fulton CP07D,CP07D,0,0,1,0,1
Fulton CP07E,CP07E,0,0,0,0,0
Fulton CP07F,CP07F,0,0,0,0,0
Fulton CP081,CP081,0,3,1,0,4
Fulton CP083,CP083,0,0,1,0,1
Fulton CP084,CP084,0,0,0,0,0
Fulton CP08A,CP08A,1,1,1,0,3
Fulton EP01A,EP01A,7,69,63,0,139
Fulton EP01B,EP01B,2,44,21,0,67
Fulton EP01C,EP01C,2,30,18,0,50
Fulton EP02A,EP02A,4,37,13,1,55
Fulton EP02B,EP02B,10,88,55,1,154
Fulton EP02C,EP02C,4,30,11,0,45
Fulton EP02D,EP02D,0,2,5,0,7
Fulton EP02E,EP02E,2,18,12,0,32
Fulton EP03A,EP03A,5,89,60,1,155
Fulton EP03B,EP03B,5,26,20,0,51
Fulton EP04A,EP04A,3,18,12,1,34
Fulton EP04B,EP04B,1,30,16,1,48
Fulton EP04C,EP04C,3,32,15,0,50
Fulton FA01A,FA01A,11,162,45,1,219
Fulton FA01B,FA01B,17,207,104,3,331
Fulton FA01C,FA01C,0,11,14,0,25
Fulton FA01D,FA01D,0,16,6,0,22
Fulton FC02,FC02,1,3,2,0,6
Fulton HP01,HP01,13,189,279,0,481
Fulton JC01,JC01,17,675,325,2,1019
Fulton JC01A,JC01A,15,235,208,1,459
Fulton JC02,JC02,29,498,281,2,810
Fulton JC03A,JC03A,3,118,61,1,183
Fulton JC03B,JC03B,6,226,151,0,383
Fulton JC04A,JC04A,21,758,234,1,1014
Fulton JC04B,JC04B,4,54,15,1,74
Fulton JC04C,JC04C,8,202,113,0,323
Fulton JC05,JC05,13,415,227,0,655
Fulton JC06,JC06,40,540,275,0,855
Fulton JC07,JC07,48,787,414,0,1249
Fulton JC08,JC08,16,615,282,0,913
Fulton JC09,JC09,24,516,265,1,806
Fulton JC10,JC10,24,391,208,4,627
Fulton JC11,JC11,37,845,330,1,1213
Fulton JC12,JC12,49,930,279,0,1258
Fulton JC13A,JC13A,25,728,243,1,997
Fulton JC13B,JC13B,0,105,41,0,146
Fulton JC14,JC14,32,665,202,0,899
Fulton JC15,JC15,6,116,82,0,204
Fulton JC16,JC16,21,547,278,0,846
Fulton JC18,JC18,33,791,298,0,1122
Fulton JC19A,JC19A,26,621,207,0,854
Fulton JC19,JC19,22,239,119,0,380
Fulton ML01A,ML01A,31,837,330,2,1200
Fulton ML01B,ML01B,8,200,85,0,293
Fulton ML01C,ML01C,1,42,20,0,63
Fulton ML02A,ML02A,34,848,471,0,1353
Fulton ML02B,ML02B,14,643,256,0,913
Fulton ML03,ML03,57,1176,390,1,1624
Fulton ML03A,ML03A,5,196,96,1,298
Fulton ML04,ML04,51,944,466,2,1463
Fulton ML05,ML05,65,1041,522,1,1629
Fulton ML06A,ML06A,15,173,148,0,336
Fulton ML06B,ML06B,21,371,267,0,659
Fulton ML07A,ML07A,9,227,161,0,397
Fulton ML07B,ML07B,31,432,288,0,751
Fulton MP01,MP01,3,25,143,0,171
Fulton PA01,PA01,16,224,68,0,308
Fulton RW01,RW01,133,1331,649,1,2114
Fulton RW02,RW02,45,959,529,0,1533
Fulton RW03,RW03,8,126,57,0,191
Fulton RW03B,RW03B,19,283,182,1,485
Fulton RW03A,RW03A,13,143,69,0,225
Fulton RW03C,RW03C,10,254,143,0,407
Fulton RW04,RW04,31,436,187,0,654
Fulton RW05,RW05,23,236,195,1,455
Fulton RW05A,RW05A,6,84,50,1,141
Fulton RW06,RW06,25,528,322,0,875
Fulton RW07A,RW07A,1,49,44,1,95
Fulton RW07B,RW07B,3,20,40,0,63
Fulton RW08,RW08,79,619,341,1,1040
Fulton RW09,RW09,64,1082,673,0,1819
Fulton RW09A,RW09A,35,683,363,0,1081
Fulton RW10,RW10,39,752,375,0,1166
Fulton RW10A,RW10A,21,312,84,1,418
Fulton RW11A,RW11A,31,568,256,3,858
Fulton RW11B,RW11B,0,0,0,0,0
Fulton RW12,RW12,26,742,536,0,1304
Fulton RW12A,RW12A,54,815,411,0,1280
Fulton RW13,RW13,32,844,448,0,1324
Fulton RW16,RW16,30,465,322,0,817
Fulton RW17,RW17,20,429,243,0,692
Fulton RW19,RW19,35,487,370,0,892
Fulton RW20,RW20,23,726,213,0,962
Fulton RW21,RW21,8,76,1,0,85
Fulton RW21A,RW21A,34,912,283,1,1230
Fulton RW22A,RW22A,22,648,257,1,928
Fulton RW22C,RW22C,0,0,0,0,0
Fulton RW22B,RW22B,0,0,0,0,0
Fulton SC01A,SC01A,0,2,1,0,3
Fulton SC01B,SC01B,1,37,12,0,50
Fulton SC01C,SC01C,10,42,10,0,62
Fulton SC02,SC02,2,19,3,0,24
Fulton SC02A,SC02A,3,14,3,0,20
Fulton SC04,SC04,4,109,51,0,164
Fulton SC05A,SC05A,1,4,2,0,7
Fulton SC05B,SC05B,0,15,6,0,21
Fulton SC05C,SC05C,3,43,17,0,63
Fulton SC05D,SC05D,4,39,22,1,66
Fulton SC05E,SC05E,1,37,17,0,55
Fulton SC07A,SC07A,9,173,53,1,236
Fulton SC07B,SC07B,0,0,0,0,0
Fulton SC07C,SC07C,0,0,0,0,0
Fulton SC07D,SC07D,0,12,7,0,19
Fulton SC07E,SC07E,3,62,15,0,80
Fulton SC08A,SC08A,0,0,0,0,0
Fulton SC08J,SC08J,0,0,0,0,0
Fulton SC08B,SC08B,3,53,24,0,80
Fulton SC08I,SC08I,1,4,0,0,5
Fulton SC08C,SC08C,1,1,0,0,2
Fulton SC08D,SC08D,1,4,5,0,10
Fulton SC08E,SC08E,0,5,6,0,11
Fulton SC08F,SC08F,2,7,4,0,13
Fulton SC08G,SC08G,0,0,0,0,0
Fulton SC08H,SC08H,0,0,0,0,0
Fulton SC09A,SC09A,2,18,11,0,31
Fulton SC09B,SC09B,6,27,13,0,46
Fulton SC09C,SC09C,3,25,17,0,45
Fulton SC10,SC10,1,14,13,0,28
Fulton SC11A,SC11A,3,14,13,0,30
Fulton SC11B,SC11B,4,20,15,0,39
Fulton SC13,SC13,1,51,24,0,76
Fulton SC13A,SC13A,0,16,2,0,18
Fulton SC14A,SC14A,0,11,12,0,23
Fulton SC15,SC15,4,74,38,0,116
Fulton SC15A,SC15A,6,39,19,0,64
Fulton SC16A,SC16A,0,37,22,0,59
Fulton SC16B,SC16B,2,30,11,3,46
Fulton SC17A,SC17A,0,0,0,0,0
Fulton SC17B,SC17B,0,0,0,0,0
Fulton SC17C,SC17C,0,14,16,0,30
Fulton SC18A,SC18A,0,7,4,0,11
Fulton SC18B,SC18B,1,14,8,0,23
Fulton SC18C,SC18C,3,39,8,0,50
Fulton SC18D,SC18D,0,13,4,0,17
Fulton SC19A,SC19A,0,7,0,0,7
Fulton SC19B,SC19B,1,12,19,0,32
Fulton SC20,SC20,0,38,23,0,61
Fulton SC211,SC211,2,39,20,0,61
Fulton SC212,SC212,9,71,53,1,134
Fulton SC21A,SC21A,0,0,0,0,0
Fulton SC23A,SC23A,1,38,39,0,78
Fulton SC23B,SC23B,0,12,2,0,14
Fulton SC23C,SC23C,4,29,20,1,54
Fulton SC27,SC27,2,32,14,0,48
Fulton SC29A,SC29A,5,29,16,1,51
Fulton SC29B,SC29B,0,0,0,0,0
Fulton SC30A,SC30A,0,2,3,0,5
Fulton SC30B,SC30B,0,12,12,0,24
Fulton SC31,SC31,0,3,0,0,3
Fulton SC32,SC32,0,1,3,0,4
Fulton SC33,SC33,0,1,0,0,1
Fulton SS01,SS01,80,937,505,1,1523
Fulton SS01A,SS01A,29,333,103,1,466
Fulton SS02A,SS02A,12,214,82,0,308
Fulton SS02B,SS02B,8,134,72,0,214
Fulton SS03A,SS03A,11,135,91,0,237
Fulton SS03,SS03,9,125,82,1,217
Fulton SS04A,SS04A,2,19,10,0,31
Fulton SS04,SS04,38,440,268,0,746
Fulton SS05,SS05,23,431,243,0,697
Fulton SS06,SS06,31,445,173,0,649
Fulton SS07A,SS07A,28,341,85,1,455
Fulton SS07B,SS07B,10,118,60,0,188
Fulton SS07C,SS07C,20,140,71,0,231
Fulton SS07D,SS07D,0,1,0,0,1
Fulton SS08A,SS08A,11,150,142,1,304
Fulton SS08B,SS08B,13,185,54,0,252
Fulton SS08E,SS08E,5,40,21,0,66
Fulton SS08C,SS08C,3,73,31,0,107
Fulton SS08D,SS08D,12,139,105,0,256
Fulton SS09A,SS09A,63,865,362,0,1290
Fulton SS09B,SS09B,79,1015,331,4,1429
Fulton SS11A,SS11A,41,522,235,1,799
Fulton SS11B,SS11B,9,122,80,0,211
Fulton SS11C,SS11C,2,13,12,0,27
Fulton SS11D,SS11D,6,91,37,0,134
Fulton SS12,SS12,71,586,278,0,935
Fulton SS13A,SS13A,20,388,199,0,607
Fulton SS13B,SS13B,11,233,83,1,328
Fulton SS14,SS14,22,486,212,0,720
Fulton SS15A,SS15A,6,85,76,0,167
Fulton SS15B,SS15B,9,135,132,0,276
Fulton SS16,SS16,45,568,277,0,890
Fulton SS17,SS17,53,669,425,2,1149
Fulton SS18A,SS18A,3,95,45,0,143
Fulton SS18C,SS18C,6,63,27,0,96
Fulton SS18B,SS18B,0,67,19,0,86
Fulton SS19A,SS19A,23,282,113,0,418
Fulton SS19B,SS19B,7,274,107,0,388
Fulton SS20,SS20,18,251,117,1,387
Fulton SS22,SS22,62,405,173,0,640
Fulton SS26,SS26,8,187,81,0,276
Fulton SS29A,SS29A,31,384,206,0,621
Fulton SS29B,SS29B,0,1,0,1,2
Fulton SS31,SS31,19,335,110,1,465
Fulton UC01A,UC01A,0,41,16,0,57
Fulton UC01B,UC01B,0,3,2,0,5
Fulton UC01C,UC01C,0,0,0,0,0
Fulton UC01D,UC01D,0,1,1,0,2
Fulton UC01E,UC01E,0,7,5,0,12
Fulton UC02A,UC02A,0,6,7,0,13
Fulton UC02E,UC02E,3,43,35,0,81
Fulton UC02B,UC02B,0,2,0,0,2
Fulton UC02C,UC02C,0,2,0,0,2
Fulton UC02D,UC02D,6,95,20,4,125
Fulton UC031,UC031,14,100,45,1,160
Fulton UC032,UC032,5,30,12,0,47
Fulton UC033,UC033,0,0,0,0,0
Fulton UC035,UC035,0,1,0,0,1
Gilmer Ellijay South,Ellijay South,67,960,504,1,1532
Gilmer Cartecay,Cartecay,40,436,473,1,950
Gilmer Tails Creek,Tails Creek,26,364,499,1,890
Gilmer Town Creek,Town Creek,14,243,388,0,645
Gilmer Leaches,Leaches,67,768,656,3,1494
Gilmer Cherry Log,Cherry Log,15,188,304,0,507
Gilmer Boardtown,Boardtown,48,461,386,1,896
Gilmer Mountaintown,Mountaintown,28,278,340,0,646
Gilmer East Ellijay,East Ellijay,57,536,343,1,937
Gilmer Ellijay North,Ellijay North,45,446,389,2,882
Gilmer Yukon,Yukon,27,266,426,0,719
Gilmer Roy Road,Roy Road,21,386,420,0,827
Gilmer Ellijay Northeast,Ellijay Northeast,67,618,342,0,1027
Glascock Edgehill,Edgehill,4,28,62,0,94
Glascock Gibson,Gibson,17,225,123,0,365
Glascock Mill,Mill,18,238,193,0,449
Glascock Mitchell,Mitchell,12,113,178,0,303
Glynn SES,SES,58,1237,677,1,1973
Glynn BRK,BRK,32,708,682,0,1422
Glynn MAR,MAR,33,640,540,1,1214
Glynn BLY,BLY,36,722,473,1,1232
Glynn NSSI,NSSI,128,1906,722,6,2762
Glynn CSSI,CSSI,142,2539,746,5,3432
Glynn SSSI,SSSI,90,1672,446,2,2210
Glynn JI,JI,25,67,230,1,323
Glynn COG,COG,45,685,535,1,1266
Glynn SEB,SEB,15,373,273,1,662
Glynn GICCA,GICCA,52,619,473,3,1147
Glynn NGLY,NGLY,39,720,564,1,1324
Glynn BAL,BAL,61,654,275,1,991
Glynn NSB,NSB,37,294,260,0,591
Glynn THE,THE,33,303,190,0,526
Glynn CPM,CPM,28,235,147,1,411
Glynn HCP,HCP,24,268,235,0,527
Glynn UPP,UPP,11,50,30,0,91
Glynn ARCO,ARCO,4,84,51,2,141
Gordon Sugar Valley,Sugar Valley,12,280,464,1,757
Gordon Plainville,Plainville,18,348,526,4,896
Gordon Sonoraville,Sonoraville,68,1156,1471,0,2695
Gordon Pine Chapel,Pine Chapel,18,193,358,0,569
Gordon Oostanaula,Oostanaula,9,108,216,0,333
Gordon Oakman,Oakman,17,155,488,1,661
Gordon Gordon County,Gordon County,84,1330,1099,2,2515
Gordon Calhoun City,Calhoun City,150,2106,1236,4,3496
Gordon Lily Pond,Lily Pond,24,456,480,0,960
Gordon Fairmount,Fairmount,39,250,753,0,1042
Gordon Red Bud,Red Bud,24,600,796,1,1421
Gordon Resaca,Resaca,18,202,438,0,658
Grady Blowing Cave,Blowing Cave,10,154,280,0,444
Grady Cairo 4th District,Cairo 4th District,19,169,50,2,240
Grady Cairo 5th District,Cairo 5th District,34,454,321,0,809
Grady Duncanville ,Duncanville ,10,77,114,0,201
Grady Higdon,Higdon,9,132,256,0,397
Grady Limesink,Limesink,5,63,99,0,167
Grady Midway,Midway,25,308,305,1,639
Grady Pine Park ,Pine Park ,10,133,205,0,348
Grady Ragan,Ragan,9,107,128,0,244
Grady Spence,Spence,11,121,259,0,391
Grady Spring Hill,Spring Hill,8,145,160,0,313
Grady Whigham,Whigham,10,209,300,0,519
Grady Woodland,Woodland,45,682,445,0,1172
Greene Greensboro,Greensboro,47,829,324,0,1200
Greene Union Point,Union Point,10,255,240,0,505
Greene Siloam,Siloam,6,155,127,0,288
Greene White Plains,White Plains,8,76,64,0,148
Greene Old Salem,Old Salem,270,3803,1187,1,5261
Gwinnett HARBINS A,HARBINS A,88,1143,643,1,1875
Gwinnett ROCKBRIDGE A,ROCKBRIDGE A,34,229,169,0,432
Gwinnett DACULA,DACULA,46,669,369,0,1084
Gwinnett SUWANEE A,SUWANEE A,32,318,183,0,533
Gwinnett BAYCREEK A,BAYCREEK A,55,342,463,0,860
Gwinnett GOODWINS A,GOODWINS A,58,375,392,0,825
Gwinnett DULUTH A,DULUTH A,76,777,469,0,1322
Gwinnett DUNCANS A,DUNCANS A,90,1127,638,0,1855
Gwinnett PUCKETTS A,PUCKETTS A,103,1623,650,0,2376
Gwinnett CATES A,CATES A,65,395,284,1,745
Gwinnett BERKSHIRE A,BERKSHIRE A,22,179,237,0,438
Gwinnett BERKSHIRE B,BERKSHIRE B,61,440,213,0,714
Gwinnett DUNCANS C,DUNCANS C,47,690,594,0,1331
Gwinnett GARNERS A,GARNERS A,74,678,398,0,1150
Gwinnett LAWRENCEVILLE A,LAWRENCEVILLE A,52,428,322,1,803
Gwinnett LAWRENCEVILLE B,LAWRENCEVILLE B,60,370,340,0,770
Gwinnett MARTINS A,MARTINS A,12,120,182,0,314
Gwinnett MARTINS B,MARTINS B,31,193,240,0,464
Gwinnett MARTINS C,MARTINS C,24,221,279,0,524
Gwinnett PINCKNEYVILLE A,PINCKNEYVILLE A,8,77,128,0,213
Gwinnett PINCKNEYVILLE B,PINCKNEYVILLE B,21,163,162,0,346
Gwinnett PINCKNEYVILLE C,PINCKNEYVILLE C,49,298,371,1,719
Gwinnett PINCKNEYVILLE D,PINCKNEYVILLE D,7,89,99,1,196
Gwinnett SUGAR HILL A,SUGAR HILL A,43,585,637,1,1266
Gwinnett SUGAR HILL B,SUGAR HILL B,81,805,884,1,1771
Gwinnett HOG MOUNTAIN A,HOG MOUNTAIN A,47,483,475,2,1007
Gwinnett HOG MOUNTAIN B,HOG MOUNTAIN B,69,785,581,0,1435
Gwinnett ROCKYCREEK A,ROCKYCREEK A,78,1101,714,0,1893
Gwinnett CATES B,CATES B,35,219,267,1,522
Gwinnett CATES C,CATES C,31,244,225,0,500
Gwinnett HOG MOUNTAIN D,HOG MOUNTAIN D,45,447,407,0,899
Gwinnett BERKSHIRE D,BERKSHIRE D,56,408,312,0,776
Gwinnett BERKSHIRE E,BERKSHIRE E,34,371,246,0,651
Gwinnett BERKSHIRE F,BERKSHIRE F,26,119,223,0,368
Gwinnett CATES D,CATES D,54,440,422,1,917
Gwinnett CATES E,CATES E,55,479,411,0,945
Gwinnett PINCKNEYVILLE E,PINCKNEYVILLE E,10,70,112,1,193
Gwinnett PINCKNEYVILLE F,PINCKNEYVILLE F,11,190,158,0,359
Gwinnett DUNCANS D,DUNCANS D,122,1792,930,1,2845
Gwinnett PINCKNEYVILLE H,PINCKNEYVILLE H,72,828,404,0,1304
Gwinnett BAYCREEK B,BAYCREEK B,37,427,486,0,950
Gwinnett LAWRENCEVILLE C,LAWRENCEVILLE C,53,411,407,0,871
Gwinnett MARTINS D,MARTINS D,24,87,101,0,212
Gwinnett ROCKBRIDGE B,ROCKBRIDGE B,31,244,211,0,486
Gwinnett GARNERS B,GARNERS B,43,352,153,0,548
Gwinnett CATES F,CATES F,32,258,311,0,601
Gwinnett CATES G,CATES G,79,516,438,0,1033
Gwinnett DULUTH B,DULUTH B,80,449,340,0,869
Gwinnett GARNERS C,GARNERS C,22,217,204,1,444
Gwinnett PINCKNEYVILLE I,PINCKNEYVILLE I,22,153,86,0,261
Gwinnett PINCKNEYVILLE J,PINCKNEYVILLE J,13,67,72,0,152
Gwinnett BERKSHIRE G,BERKSHIRE G,43,459,236,0,738
Gwinnett CATES H,CATES H,25,273,193,0,491
Gwinnett SUGAR HILL C,SUGAR HILL C,63,810,963,0,1836
Gwinnett SUGAR HILL D,SUGAR HILL D,62,864,567,4,1497
Gwinnett DULUTH C,DULUTH C,30,296,226,0,552
Gwinnett DULUTH D,DULUTH D,62,482,347,0,891
Gwinnett PINCKNEYVILLE K,PINCKNEYVILLE K,20,134,170,0,324
Gwinnett PINCKNEYVILLE N,PINCKNEYVILLE N,9,134,144,0,287
Gwinnett LAWRENCEVILLE D,LAWRENCEVILLE D,43,254,188,0,485
Gwinnett LAWRENCEVILLE E,LAWRENCEVILLE E,64,310,269,0,643
Gwinnett PINCKNEYVILLE L,PINCKNEYVILLE L,70,541,481,0,1092
Gwinnett PINCKNEYVILLE M,PINCKNEYVILLE M,86,696,519,0,1301
Gwinnett GARNERS D,GARNERS D,44,247,137,0,428
Gwinnett BERKSHIRE H,BERKSHIRE H,15,146,139,0,300
Gwinnett PINCKNEYVILLE O,PINCKNEYVILLE O,20,183,111,0,314
Gwinnett PUCKETTS E,PUCKETTS E,67,819,493,2,1381
Gwinnett CATES I,CATES I,35,387,481,0,903
Gwinnett CATES J,CATES J,56,380,361,0,797
Gwinnett GOODWINS B,GOODWINS B,62,627,546,0,1235
Gwinnett LAWRENCEVILLE F,LAWRENCEVILLE F,31,284,179,1,495
Gwinnett MARTINS E,MARTINS E,22,119,117,1,259
Gwinnett PINCKNEYVILLE P,PINCKNEYVILLE P,62,282,193,0,537
Gwinnett PINCKNEYVILLE Q,PINCKNEYVILLE Q,6,40,77,1,124
Gwinnett ROCKBRIDGE C,ROCKBRIDGE C,33,280,190,1,504
Gwinnett ROCKBRIDGE D,ROCKBRIDGE D,38,344,128,0,510
Gwinnett GOODWINS C,GOODWINS C,65,418,412,0,895
Gwinnett BAYCREEK K,BAYCREEK K,78,489,347,0,914
Gwinnett CATES K,CATES K,51,316,429,0,796
Gwinnett BAYCREEK C,BAYCREEK C,73,645,618,0,1336
Gwinnett CATES L,CATES L,82,490,298,0,870
Gwinnett DULUTH E,DULUTH E,36,468,306,0,810
Gwinnett GOODWINS D,GOODWINS D,53,415,511,0,979
Gwinnett LAWRENCEVILLE G,LAWRENCEVILLE G,23,190,224,0,437
Gwinnett LAWRENCEVILLE H,LAWRENCEVILLE H,90,532,535,0,1157
Gwinnett MARTINS F,MARTINS F,14,116,152,0,282
Gwinnett PINCKNEYVILLE S,PINCKNEYVILLE S,40,316,263,1,620
Gwinnett ROCKBRIDGE E,ROCKBRIDGE E,16,247,206,2,471
Gwinnett SUGAR HILL E,SUGAR HILL E,58,557,504,0,1119
Gwinnett LAWRENCEVILLE I,LAWRENCEVILLE I,52,279,250,1,582
Gwinnett BAYCREEK D,BAYCREEK D,72,514,562,0,1148
Gwinnett BERKSHIRE J,BERKSHIRE J,60,496,345,0,901
Gwinnett CATES M,CATES M,87,598,538,0,1223
Gwinnett CATES N,CATES N,83,454,394,0,931
Gwinnett DULUTH F,DULUTH F,47,262,173,2,484
Gwinnett DULUTH G,DULUTH G,55,526,314,0,895
Gwinnett GOODWINS E,GOODWINS E,61,615,586,1,1263
Gwinnett GOODWINS F,GOODWINS F,42,340,333,0,715
Gwinnett PINCKNEYVILLE T,PINCKNEYVILLE T,37,278,316,0,631
Gwinnett SUWANEE B,SUWANEE B,61,1004,363,0,1428
Gwinnett PINCKNEYVILLE U,PINCKNEYVILLE U,27,156,273,0,456
Gwinnett PUCKETTS B,PUCKETTS B,57,646,438,1,1142
Gwinnett BERKSHIRE L,BERKSHIRE L,24,171,193,1,389
Gwinnett ROCKBRIDGE F,ROCKBRIDGE F,44,407,119,0,570
Gwinnett SUGAR HILL F,SUGAR HILL F,44,620,612,0,1276
Gwinnett SUWANEE C,SUWANEE C,85,936,516,4,1541
Gwinnett CATES O,CATES O,28,157,272,0,457
Gwinnett BAYCREEK E,BAYCREEK E,41,295,293,0,629
Gwinnett BERKSHIRE M,BERKSHIRE M,25,300,244,1,570
Gwinnett MARTINS G,MARTINS G,11,100,181,0,292
Gwinnett DULUTH H,DULUTH H,69,417,262,0,748
Gwinnett BERKSHIRE N,BERKSHIRE N,53,716,243,0,1012
Gwinnett PINCKNEYVILLE V,PINCKNEYVILLE V,20,142,156,0,318
Gwinnett PINCKNEYVILLE W,PINCKNEYVILLE W,38,590,381,0,1009
Gwinnett MARTINS H,MARTINS H,63,322,401,0,786
Gwinnett MARTINS I,MARTINS I,50,191,251,0,492
Gwinnett MARTINS J,MARTINS J,18,159,180,1,358
Gwinnett GARNERS F,GARNERS F,29,295,167,0,491
Gwinnett BERKSHIRE O,BERKSHIRE O,48,402,398,0,848
Gwinnett BERKSHIRE P,BERKSHIRE P,16,111,123,0,250
Gwinnett PINCKNEYVILLE X,PINCKNEYVILLE X,83,611,352,0,1046
Gwinnett ROCKBRIDGE G,ROCKBRIDGE G,37,368,210,0,615
Gwinnett PINCKNEYVILLE Y,PINCKNEYVILLE Y,8,109,150,0,267
Gwinnett GOODWINS G,GOODWINS G,27,148,224,0,399
Gwinnett PINCKNEYVILLE Z,PINCKNEYVILLE Z,40,413,410,0,863
Gwinnett PINCKNEYVILLE A1,PINCKNEYVILLE A1,81,672,485,0,1238
Gwinnett LAWRENCEVILLE J,LAWRENCEVILLE J,14,144,186,0,344
Gwinnett GOODWINS H,GOODWINS H,23,306,342,0,671
Gwinnett DUNCANS B,DUNCANS B,89,1095,1016,1,2201
Gwinnett SUWANEE D,SUWANEE D,76,933,745,0,1754
Gwinnett SUWANEE E,SUWANEE E,72,905,542,0,1519
Gwinnett LAWRENCEVILLE K,LAWRENCEVILLE K,55,398,390,0,843
Gwinnett HARBINS B,HARBINS B,52,1014,420,0,1486
Gwinnett BAYCREEK F,BAYCREEK F,49,346,404,0,799
Gwinnett PUCKETTS C,PUCKETTS C,57,615,445,1,1118
Gwinnett HOG MOUNTAIN C,HOG MOUNTAIN C,62,601,562,0,1225
Gwinnett ROCKYCREEK B,ROCKYCREEK B,51,743,611,1,1406
Gwinnett DULUTH I,DULUTH I,127,873,541,0,1541
Gwinnett MARTINS K,MARTINS K,35,207,361,0,603
Gwinnett SUWANEE H,SUWANEE H,69,998,575,2,1644
Gwinnett SUGAR HILL G,SUGAR HILL G,41,605,452,0,1098
Gwinnett SUWANEE F,SUWANEE F,43,601,433,1,1078
Gwinnett LAWRENCEVILLE L,LAWRENCEVILLE L,71,463,435,0,969
Gwinnett LAWRENCEVILLE M,LAWRENCEVILLE M,33,399,304,1,737
Gwinnett BAYCREEK G,BAYCREEK G,69,510,465,1,1045
Gwinnett BAYCREEK H,BAYCREEK H,98,866,721,1,1686
Gwinnett BAYCREEK I,BAYCREEK I,71,586,476,1,1134
Gwinnett BERKSHIRE Q,BERKSHIRE Q,21,232,247,1,501
Gwinnett GOODWINS I,GOODWINS I,31,322,355,1,709
Gwinnett DULUTH K,DULUTH K,13,103,78,0,194
Gwinnett HARBINS C,HARBINS C,25,360,578,0,963
Gwinnett ROCKYCREEK C,ROCKYCREEK C,55,944,535,0,1534
Gwinnett LAWRENCEVILLE N,LAWRENCEVILLE N,32,207,219,0,458
Gwinnett PUCKETTS D,PUCKETTS D,70,760,396,0,1226
Gwinnett SUWANEE G,SUWANEE G,45,557,465,0,1067
Gwinnett BAYCREEK J,BAYCREEK J,49,317,317,0,683
Habersham Habersham North,Habersham North,205,3925,1147,0,5277
Habersham Habersham South,Habersham South,175,1774,1011,4,2964
Habersham Demorest,Demorest,110,1846,734,1,2691
Habersham Town of Mount Airy,Town of Mount Airy,17,161,178,1,357
Habersham City of Baldwin,City of Baldwin,0,4,0,0,4
Habersham Mud Creek,Mud Creek,104,1303,860,2,2269
Habersham Amys Creek,Amys Creek,41,530,380,0,951
Hall Wilson,Wilson,270,1668,734,1,2673
Hall Chicopee,Chicopee,61,539,395,0,995
Hall Oakwood I,Oakwood I,36,355,368,0,759
Hall Oakwood II,Oakwood II,118,1222,841,2,2183
Hall Flowery Branch I,Flowery Branch I,88,1352,838,0,2278
Hall Flowery Branch II,Flowery Branch II,52,820,755,0,1627
Hall Roberts,Roberts,124,1662,1019,0,2805
Hall Morgan I,Morgan I,64,1164,833,1,2062
Hall Morgan II,Morgan II,115,1260,684,2,2061
Hall Candler,Candler,79,1283,900,0,2262
Hall Tadmore,Tadmore,53,681,543,0,1277
Hall Glade,Glade,78,893,586,1,1558
Hall Lula,Lula,54,924,774,0,1752
Hall Clermont,Clermont,53,1307,792,0,2152
Hall Quillians,Quillians,44,1159,582,1,1786
Hall Bark Camp,Bark Camp,120,1878,896,0,2894
Hall Chestatee,Chestatee,97,1108,732,0,1937
Hall Fork,Fork,97,905,806,0,1808
Hall Whelchel,Whelchel,90,1443,653,1,2187
Hall West Whelchel,West Whelchel,226,1357,701,0,2284
Hall Gainesville I,Gainesville I,108,854,485,0,1447
Hall Gainesville II,Gainesville II,37,85,67,0,189
Hall Gainesville III,Gainesville III,62,353,374,0,789
Hall Gainesville IV,Gainesville IV,50,570,257,0,877
Hall Gainesville V,Gainesville V,25,302,168,0,495
Hall Gillsville,Gillsville,13,240,369,0,622
Hall Big Hickory,Big Hickory,108,1635,714,0,2457
Hall Friendship I,Friendship I,361,3206,1306,0,4873
Hall Friendship II,Friendship II,57,953,685,1,1696
Hall Friendship III,Friendship III,47,1285,581,0,1913
Hall Friendship IV,Friendship IV,52,1390,433,0,1875
Hancock Devereux Fire,Devereux Fire,23,253,138,0,414
Hancock St Mark,St Mark,6,26,24,0,56
Hancock Courthouse,Courthouse,5,69,46,0,120
Hancock Second Beulah,Second Beulah,3,17,19,0,39
Hancock Mayfield Community Center,Mayfield Community Center,3,11,11,0,25
Hancock Power of God,Power of God,6,50,28,0,84
Hancock Warren Chapel,Warren Chapel,8,74,45,0,127
Hancock Youth Center,Youth Center,15,59,31,0,105
Hancock Second Darrien,Second Darrien,0,25,59,0,84
Hancock Sparta 4C,Sparta 4C,0,7,12,0,19
Haralson Bremen,Bremen,146,1592,1486,0,3224
Haralson Buchanan,Buchanan,36,672,565,0,1273
Haralson Buncombe,Buncombe,10,182,322,0,514
Haralson Corinth,Corinth,33,318,510,0,861
Haralson Twentieth,Twentieth,5,158,284,0,447
Haralson Felton,Felton,5,51,141,0,197
Haralson Little Creek,Little Creek,18,99,315,0,432
Haralson Mt View,Mt View,5,47,158,0,210
Haralson Seventh,Seventh,26,412,518,0,956
Haralson Berea-Steadman,Berea-Steadman,17,108,251,0,376
Haralson Tallapoosa,Tallapoosa,58,564,721,0,1343
Haralson Waco,Waco,12,189,364,0,565
Harris Cataula,Cataula,43,716,748,3,1510
Harris Ellerslie,Ellerslie,105,931,1054,0,2090
Harris Goodman,Goodman,23,377,351,0,751
Harris Hamilton,Hamilton,46,656,444,0,1146
Harris Lower 19th,Lower 19th,64,505,825,1,1395
Harris Mulberry Grove,Mulberry Grove,53,780,790,0,1623
Harris Pine Mountain Valley,Pine Mountain Valley,20,231,405,0,656
Harris Skinner,Skinner,15,64,319,0,398
Harris Upper 19th,Upper 19th,56,420,552,0,1028
Harris Valley Plains,Valley Plains,6,91,235,0,332
Harris Waverly Hall,Waverly Hall,35,528,688,0,1251
Harris Whitesville,Whitesville,20,303,421,0,744
Hart Hartwell,Hartwell,89,1842,874,0,2805
Hart Goldmine,Goldmine,26,399,533,0,958
Hart Cokesbury,Cokesbury,10,195,216,0,421
Hart Reed Creek,Reed Creek,84,1048,772,0,1904
Hart Bowersville,Bowersville,14,253,477,0,744
Hart Shoal Creek,Shoal Creek,30,420,502,0,952
Hart Bio,Bio,21,243,378,0,642
Heard Centralhatchee,Centralhatchee,63,414,592,0,1069
Heard Cooksville-Corinth,Cooksville-Corinth,12,107,194,0,313
Heard Enon Grove,Enon Grove,34,183,316,1,534
Heard Ephesus,Ephesus,44,218,472,0,734
Heard Franklin,Franklin,61,464,400,0,925
Heard Southwest,Southwest,17,82,184,0,283
Henry Locust Grove,Locust Grove,36,785,313,0,1134
Henry Tussahaw,Tussahaw,30,841,732,0,1603
Henry Sandy Ridge,Sandy Ridge,49,978,983,0,2010
Henry Westside,Westside,28,224,123,0,375
Henry Lowes,Lowes,59,952,419,0,1430
Henry South Hampton,South Hampton,29,917,385,0,1331
Henry North Hampton,North Hampton,41,956,362,0,1359
Henry Mount Carmel,Mount Carmel,23,420,205,0,648
Henry Red Oak,Red Oak,30,254,143,0,427
Henry Wesley Lakes,Wesley Lakes,27,453,165,1,646
Henry McDonough,McDonough,21,260,151,0,432
Henry McMullen,McMullen,28,715,722,0,1465
Henry East Lake,East Lake,44,979,475,1,1499
Henry Hickory Flat,Hickory Flat,34,652,241,0,927
Henry Stockbridge East-West,Stockbridge East-West,33,299,146,0,478
Henry Stagecoach,Stagecoach,17,446,199,0,662
Henry Cotton Indian,Cotton Indian,43,630,268,1,942
Henry Pleasant Grove,Pleasant Grove,70,800,355,1,1226
Henry Austin Road,Austin Road,22,370,173,0,565
Henry Swan Lake,Swan Lake,31,652,286,0,969
Henry Shakerag,Shakerag,14,181,91,0,286
Henry Ellenwood,Ellenwood,30,295,86,0,411
Henry Unity Grove,Unity Grove,44,1207,641,0,1892
Henry Shiloh,Shiloh,11,358,162,0,531
Henry Pates Creek,Pates Creek,75,693,320,3,1091
Henry Oakland,Oakland,44,721,320,0,1085
Henry Lake Dow,Lake Dow,63,1017,659,0,1739
Henry Flippen,Flippen,62,453,185,0,700
Henry Stockbridge Central,Stockbridge Central,18,350,133,0,501
Henry Kelleytown,Kelleytown,28,705,558,1,1292
Henry Lighthouse,Lighthouse,45,431,233,0,709
Henry Dutchtown,Dutchtown,38,477,202,0,717
Henry Mt Bethel,Mt Bethel,25,414,949,0,1388
Henry Grove Park,Grove Park,23,715,311,0,1049
Henry Lake Haven,Lake Haven,52,637,435,0,1124
Henry McDonough Central,McDonough Central,70,724,185,0,979
Henry Timberridge,Timberridge,22,348,400,0,770
Houston ANNX,ANNX,112,1257,537,0,1906
Houston BMS,BMS,206,2600,1427,2,4235
Houston CENT,CENT,130,1365,953,0,2448
Houston CGTC,CGTC,81,1387,490,1,1959
Houston FMMS,FMMS,92,1632,1093,1,2818
Houston HAFS,HAFS,20,395,628,0,1043
Houston HCTC,HCTC,79,850,437,0,1366
Houston HEFS,HEFS,27,294,370,0,691
Houston HHPC,HHPC,104,1415,593,1,2113
Houston MCMS,MCMS,85,2228,1267,3,3583
Houston NHSC,NHSC,46,539,307,0,892
Houston ROZR,ROZR,277,3774,1567,1,5619
Houston TMS,TMS,61,647,409,0,1117
Houston TWPK,TWPK,74,854,601,0,1529
Houston VHS,VHS,75,1697,1026,3,2801
Houston WELL,WELL,60,411,251,0,722
Irwin Irwinville,Irwinville,33,454,500,0,987
Irwin Ocilla,Ocilla,24,823,481,1,1329
Irwin Holt,Holt,10,184,185,0,379
Jackson Central Jackson,Central Jackson,211,5045,2796,0,8052
Jackson North Jackson,North Jackson,213,3502,2101,4,5820
Jackson West Jackson,West Jackson,305,5161,3223,1,8690
Jackson South Jackson,South Jackson,128,2073,1459,1,3661
Jasper Wyatt,Wyatt,23,332,605,1,961
Jasper Monticello,Monticello,124,1273,570,5,1972
Jasper Martin & Burney,Martin & Burney,43,999,1262,0,2304
Jeff Davis Hazlehurst,Hazlehurst,8,177,135,0,320
Jeff Davis Altamaha 1,Altamaha 1,11,180,175,0,366
Jeff Davis Altamaha 2,Altamaha 2,13,320,446,0,779
Jeff Davis Blackburn 1,Blackburn 1,6,127,120,0,253
Jeff Davis Blackburn 2,Blackburn 2,7,173,244,0,424
Jeff Davis Whitehead 1,Whitehead 1,9,254,163,0,426
Jeff Davis Whitehead 2,Whitehead 2,2,118,242,1,363
Jeff Davis Ocmulgee 1,Ocmulgee 1,20,380,267,0,667
Jeff Davis Ocmulgee 2,Ocmulgee 2,4,119,144,0,267
Jefferson Stapleton Crossroads,Stapleton Crossroads,11,71,106,0,188
Jefferson Matthews,Matthews,5,43,226,0,274
Jefferson Wrens,Wrens,33,298,440,1,772
Jefferson Louisville,Louisville,48,665,269,0,982
Jefferson Wadley,Wadley,15,174,124,0,313
Jefferson Bartow,Bartow,7,60,94,0,161
Jefferson Stapleton,Stapleton,9,49,203,0,261
Jefferson Avera,Avera,4,28,179,0,211
Jenkins Primary School,Primary School,15,128,74,1,218
Jenkins Court House,Court House,17,140,71,0,228
Jenkins Perkins,Perkins,21,290,171,1,483
Jenkins Senior Citizens Center,Senior Citizens Center,25,310,207,0,542
Jenkins Four Points,Four Points,4,145,273,0,422
Johnson Wrightsville,Wrightsville,63,758,308,0,1129
Johnson Smith,Smith,12,151,279,0,442
Johnson Bray,Bray,15,190,187,0,392
Johnson Kite,Kite,10,189,342,0,541
Jones Gray,Gray,60,882,414,0,1356
Jones Hawkins,Hawkins,29,393,288,0,710
Jones Ethridge,Ethridge,41,398,259,0,698
Jones Clinton,Clinton,46,661,431,0,1138
Jones Roberts,Roberts,60,374,503,0,937
Jones Davidson,Davidson,19,373,417,0,809
Jones Pope,Pope,16,395,427,0,838
Jones Barron,Barron,18,286,352,0,656
Jones Sanders,Sanders,2,21,98,0,121
Jones Finney,Finney,54,539,727,0,1320
Lamar Barnesville,Barnesville,25,236,185,1,447
Lamar Chappell Mill V. FD,Chappell Mill V. FD,24,366,489,1,880
Lamar Senior Citzen Bldg,Senior Citzen Bldg,19,232,172,0,423
Lamar Redbone,Redbone,10,162,266,0,438
Lamar L C S C,L C S C,54,1015,636,1,1706
Lamar Milner,Milner,38,925,877,2,1842
Lanier Lakeland,Lakeland,40,1143,749,0,1932
Laurens FBC-FLC,FBC-FLC,119,1005,499,2,1625
Laurens Calhoun Park,Calhoun Park,43,337,255,0,635
Laurens Fire Dept Station 5,Fire Dept Station 5,89,973,763,0,1825
Laurens Buckeye,Buckeye,8,98,216,0,322
Laurens Burch,Burch,5,34,196,0,235
Laurens Cadwell,Cadwell,12,102,308,0,422
Laurens Brewton,Brewton,20,260,522,0,802
Laurens Dudley,Dudley,27,266,528,1,822
Laurens Hampton Mill,Hampton Mill,25,249,752,0,1026
Laurens Minter,Minter,23,145,398,5,571
Laurens Rural Fire Station 7,Rural Fire Station 7,32,380,628,1,1041
Laurens WT Adams Fire Station 18,WT Adams Fire Station 18,64,469,538,0,1071
Laurens Reedy Springs,Reedy Springs,8,85,399,0,492
Laurens Smith,Smith,38,330,492,0,860
Laurens LCFS #10,LCFS #10,30,315,414,0,759
Lee Chokee,Chokee,6,74,78,0,158
Lee Redbone,Redbone,40,1082,1138,1,2261
Lee Smithville ,Smithville ,7,160,167,0,334
Lee CJC,CJC,4,175,186,0,365
Lee Leesburg,Leesburg,26,721,504,0,1251
Lee Friendship Baptist,Friendship Baptist,7,337,383,0,727
Lee First Baptist,First Baptist,36,888,961,1,1886
Lee SDA Church,SDA Church,24,394,416,0,834
Lee Flint Reformed Baptist ,Flint Reformed Baptist ,15,516,484,0,1015
Lee Century Fire Station,Century Fire Station,56,666,541,0,1263
Liberty Riceboro,Riceboro,10,73,55,0,138
Liberty Lyman Hall,Lyman Hall,22,255,138,0,415
Liberty Lewis Frasier,Lewis Frasier,26,241,149,0,416
Liberty Memorial Dr,Memorial Dr,7,117,85,0,209
Liberty Performing Arts CTR,Performing Arts CTR,6,168,131,0,305
Liberty Town of Allenhurst,Town of Allenhurst,8,106,83,0,197
Liberty Hinesville,Hinesville,32,400,223,0,655
Liberty Liberty County Complex,Liberty County Complex,50,967,451,0,1468
Liberty Victory Baptist,Victory Baptist,12,191,182,0,385
Liberty Fleming East,Fleming East,30,458,422,0,910
Liberty Gum Branch,Gum Branch,25,270,388,0,683
Liberty Progressive Church,Progressive Church,14,173,101,0,288
Lincoln Midway,Midway,8,159,145,0,312
Lincoln Lincoln Club House,Lincoln Club House,10,170,126,0,306
Lincoln Lincoln Center,Lincoln Center,19,400,264,0,683
Lincoln Faith Temple of Lincoln,Faith Temple of Lincoln,7,147,121,0,275
Lincoln Tabernacle,Tabernacle,15,213,208,0,436
Lincoln Bethany Church,Bethany Church,20,149,135,1,305
Lincoln Martins Crossroad,Martins Crossroad,26,304,319,0,649
Long Breads Creek,Breads Creek,11,199,340,0,550
Long Rye Patch_Oak Dale,Rye Patch_Oak Dale,13,309,319,1,642
Long South Ludowici,South Ludowici,6,224,207,0,437
Long North Ludowici,North Ludowici,12,290,206,0,508
Long Tibet,Tibet,10,225,211,0,446
Long Alma Flournoy,Alma Flournoy,0,31,26,0,57
Long Faith Baptist Annex,Faith Baptist Annex,6,181,117,0,304
Lowndes Train Depot,Train Depot,24,613,661,0,1298
Lowndes Historical Society ,Historical Society ,9,373,397,0,779
Lowndes Hahira Community Center ,Hahira Community Center ,9,248,291,2,550
Lowndes Pine Grove Church,Pine Grove Church,12,271,158,0,441
Lowndes Trinity Church,Trinity Church,22,513,332,5,872
Lowndes Nazarene Church,Nazarene Church,48,1037,577,4,1666
Lowndes Mathis Auditorium ,Mathis Auditorium ,145,2792,993,5,3935
Lowndes Jaycee Community Center,Jaycee Community Center,10,121,60,0,191
Lowndes Lowndes Civic,Lowndes Civic,35,641,446,4,1126
Lowndes Naylor Community Center,Naylor Community Center,8,253,273,0,534
Lowndes Rainwater,Rainwater,142,3541,1602,7,5292
Lowndes VSU,VSU,0,0,4,0,4
Lowndes Mt. Calvary Church,Mt. Calvary Church,1,73,39,0,113
Lowndes Mildred Community Center,Mildred Community Center,2,18,14,1,35
Lowndes Paper Mill Union,Paper Mill Union,15,385,474,5,879
Lowndes Dasher City Hall,Dasher City Hall,19,481,588,1,1089
Lowndes Lake Park,Lake Park,26,574,780,7,1387
Lowndes South Lowndes Recreation Center,South Lowndes Recreation Center,29,498,531,7,1065
Lumpkin Dahlonega,Dahlonega,383,6767,3370,5,10525
Macon Ideal,Ideal,9,258,194,0,461
Macon Oglethorpe,Oglethorpe,8,206,95,0,309
Macon Marshallville,Marshallville,8,173,153,0,334
Macon Montezuma #4,Montezuma #4,9,206,76,0,291
Macon Montezuma #5,Montezuma #5,5,112,39,0,156
Madison Colbert,Colbert,52,746,672,1,1471
Madison Collins,Collins,14,138,227,0,379
Madison Comer,Comer,15,246,335,1,597
Madison Danielsville,Danielsville,62,1084,404,1,1551
Madison Fork,Fork,8,47,194,0,249
Madison Harrison,Harrison,12,94,280,1,387
Madison Hull,Hull,79,810,825,0,1714
Madison Ila,Ila,31,412,418,0,861
Madison Mill,Mill,47,496,420,0,963
Madison Paoli,Paoli,0,53,123,0,176
Madison Pittman,Pittman,57,457,494,3,1011
Madison Poca,Poca,10,253,333,0,596
Marion Pineknot,Pineknot,10,144,326,0,480
Marion Buena Vista,Buena Vista,30,384,170,0,584
Marion Tazewell,Tazewell,7,53,139,0,199
Marion Brantley,Brantley,5,114,124,0,243
Marion Fort Perry,Fort Perry,14,107,241,0,362
McDuffie NMcDuffie,NMcDuffie,29,614,274,0,917
McDuffie Cedar Rock,Cedar Rock,82,821,359,0,1262
McDuffie Depot,Depot,12,90,47,0,149
McDuffie Sweetwater,Sweetwater,23,315,156,0,494
McDuffie White Oak,White Oak,53,734,293,0,1080
McDuffie Dearing,Dearing,37,494,354,0,885
McDuffie Fort Creek,Fort Creek,11,285,200,0,496
McIntosh Sapelo Island,Sapelo Island,0,4,5,0,9
McIntosh Crescent,Crescent,8,282,153,0,443
McIntosh Darien,Darien,52,559,252,0,863
McIntosh South Newport,South Newport,64,722,560,0,1346
McIntosh North Darien,North Darien,47,556,306,0,909
Meriwether Chalybeate,Chalybeate,4,53,188,1,246
Meriwether Gill I,Gill I,28,213,351,0,592
Meriwether Gill II,Gill II,4,59,57,0,120
Meriwether 7th-Odessadale,7th-Odessadale,4,63,69,0,136
Meriwether 8th-Greenville,8th-Greenville,19,342,222,0,583
Meriwether Lone Oak,Lone Oak,9,200,269,0,478
Meriwether Luthersville,Luthersville,37,458,523,0,1018
Meriwether Upper 9th-Alvaton,Upper 9th-Alvaton,21,248,431,0,700
Meriwether Middle 9th-Gay,Middle 9th-Gay,5,62,144,0,211
Meriwether Lower 9th-Woodbury,Lower 9th-Woodbury,18,209,218,1,446
Meriwether 2nd-Warm Springs,2nd-Warm Springs,24,173,277,0,474
Meriwether Third-Durand,Third-Durand,10,111,181,0,302
Meriwether Raleigh,Raleigh,8,120,133,0,261
Meriwether Cove,Cove,4,32,101,0,137
Miller Colquitt-Miller,Colquitt-Miller,89,913,687,0,1689
Mitchell Baconton,Baconton,6,113,220,0,339
Mitchell Branchville,Branchville,8,92,242,1,343
Mitchell Camilla North,Camilla North,7,153,61,0,221
Mitchell Camilla South,Camilla South,82,729,258,0,1069
Mitchell Cotton,Cotton,8,53,195,0,256
Mitchell Hopeful,Hopeful,5,52,125,0,182
Mitchell Hinsonton,Hinsonton,1,5,81,0,87
Mitchell Lester,Lester,28,194,357,0,579
Mitchell Pebble City,Pebble City,5,22,70,0,97
Mitchell Pelham,Pelham,37,420,391,1,849
Mitchell Sale City,Sale City,6,22,147,0,175
Monroe Bentons,Bentons,40,704,586,1,1331
Monroe Brantleys,Brantleys,6,415,295,0,716
Monroe Burgays,Burgays,55,703,729,1,1488
Monroe Cabaniss,Cabaniss,6,132,232,0,370
Monroe Cox,Cox,7,210,214,0,431
Monroe Culloden,Culloden,5,72,136,1,214
Monroe Dillards,Dillards,8,277,257,1,543
Monroe Evers,Evers,21,703,468,1,1193
Monroe Forsyth,Forsyth,50,831,365,0,1246
Monroe High Falls,High Falls,14,426,493,0,933
Monroe Kelseys,Kelseys,3,109,168,0,280
Monroe Middlebrooks,Middlebrooks,10,423,285,0,718
Monroe Proctors,Proctors,7,238,327,0,572
Monroe Russellville,Russellville,2,99,178,0,279
Montgomery Ailey,Ailey,5,129,87,0,221
Montgomery Alston,Alston,4,89,189,0,282
Montgomery Higgston,Higgston,17,278,368,0,663
Montgomery Kibbee,Kibbee,6,75,239,0,320
Montgomery Mount Vernon,Mount Vernon,20,266,176,0,462
Montgomery Tarrytown,Tarrytown,2,48,152,0,202
Montgomery Uvalda,Uvalda,14,130,251,0,395
Morgan Rec Dept,Rec Dept,24,525,175,0,724
Morgan Centennial,Centennial,42,888,812,0,1742
Morgan Gibbs,Gibbs,52,855,808,1,1716
Morgan DFACS,DFACS,49,1169,525,5,1748
Morgan Buckhead,Buckhead,50,956,827,1,1834
Murray McDonald,McDonald,18,599,522,0,1139
Murray Shuck Pen,Shuck Pen,13,465,844,0,1322
Murray Southwest,Southwest,5,475,858,0,1338
Murray Spring Place,Spring Place,22,747,834,0,1603
Murray Town,Town,85,1601,1161,0,2847
Murray Carters-Doolittle,Carters-Doolittle,19,350,606,0,975
Murray North,North,20,362,684,0,1066
Muscogee Wynnton,Wynnton,34,306,250,0,590
Muscogee Carver/Library,Carver/Library,3,45,29,0,77
Muscogee Shirley Winston,Shirley Winston,20,87,49,0,156
Muscogee Britt David,Britt David,38,273,479,0,790
Muscogee St Peter,St Peter,55,447,661,0,1163
Muscogee Chattahoochee,Chattahoochee,115,1010,1024,2,2151
Muscogee Columbus Tech,Columbus Tech,30,408,311,0,749
Muscogee Central,Central,115,1527,1156,0,2798
Muscogee Wynnbrook,Wynnbrook,121,779,467,0,1367
Muscogee Cusseta Rd,Cusseta Rd,8,41,50,0,99
Muscogee OLOLC,OLOLC,41,161,222,0,424
Muscogee Mt Pilgrim,Mt Pilgrim,16,76,60,0,152
Muscogee Faith Tabernacle,Faith Tabernacle,11,75,67,0,153
Muscogee Canaan,Canaan,72,221,140,0,433
Muscogee Holsey,Holsey,34,218,111,0,363
Muscogee Gentian,Gentian,94,691,546,0,1331
Muscogee St Paul,St Paul,115,1092,719,0,1926
Muscogee Moon,Moon,97,771,740,0,1608
Muscogee St Andrews,St Andrews,130,1202,1151,0,2483
Muscogee Salvation Army,Salvation Army,37,326,380,0,743
Muscogee First African,First African,12,90,106,0,208
Muscogee Epworth,Epworth,47,404,515,0,966
Muscogee Gallops,Gallops,12,142,117,0,271
Muscogee Edgewood,Edgewood,30,196,258,0,484
Muscogee Psalmond,Psalmond,122,1245,1073,0,2440
Newton 01-City Pond,01-City Pond,19,106,170,0,295
Newton 02-Town,02-Town,35,258,158,0,451
Newton 03-Almon,03-Almon,39,253,270,0,562
Newton 04-Alcovy,04-Alcovy,104,678,693,0,1475
Newton 05-Covington Mills,05-Covington Mills,47,363,347,0,757
Newton 06-Brewers,06-Brewers,54,416,1012,1,1483
Newton 07-Brick Store,07-Brick Store,57,436,790,1,1284
Newton 08-Cedar Shoals,08-Cedar Shoals,27,213,276,0,516
Newton 09-Livingston,09-Livingston,22,278,265,0,565
Newton 10-Downs,10-Downs,50,884,530,0,1464
Newton 12-Gum Creek,12-Gum Creek,129,916,839,0,1884
Newton 13-Beaverdam,13-Beaverdam,33,284,212,0,529
Newton 14-Leguinn,14-Leguinn,34,330,647,0,1011
Newton 15-Mansfield,15-Mansfield,30,180,738,0,948
Newton 16-Newborn,16-Newborn,10,67,376,0,453
Newton 17-Oxford,17-Oxford,41,362,577,0,980
Newton 18-Rocky Plains,18-Rocky Plains,27,390,578,0,995
Newton 19-Buck Creek,19-Buck Creek,32,592,396,0,1020
Newton 20-Stansells,20-Stansells,42,305,247,0,594
Newton 23-Fairview,23-Fairview,13,95,72,0,180
Newton 24-Crowell,24-Crowell,15,144,105,0,264
Newton 25-Hub,25-Hub,72,458,854,0,1384
Oconee City Hall,City Hall,60,1323,520,0,1903
Oconee Colham Ferry,Colham Ferry,48,1399,506,0,1953
Oconee Bishop,Bishop,33,939,506,0,1478
Oconee North Oconee,North Oconee,55,1170,604,1,1830
Oconee Dark Corner,Dark Corner,53,1439,887,0,2379
Oconee Bogart,Bogart,36,653,517,0,1206
Oconee Marswood Hall,Marswood Hall,135,1382,636,0,2153
Oconee Civic Center,Civic Center,213,2618,820,0,3651
Oglethorpe Beaverdam,Beaverdam,67,811,754,0,1632
Oglethorpe Crawford,Crawford,71,771,478,0,1320
Oglethorpe Lexington,Lexington,124,1333,589,0,2046
Paulding Burnt Hickory Park,Burnt Hickory Park,106,2175,1245,1,3527
Paulding Crossroads Library,Crossroads Library,66,1111,726,0,1903
Paulding Shelton Elementary,Shelton Elementary,72,1137,929,0,2138
Paulding Russom Elementary,Russom Elementary,269,2620,1907,0,4796
Paulding Paulding Sr Center,Paulding Sr Center,61,1303,909,2,2275
Paulding Legacy Bapt Church,Legacy Bapt Church,114,938,449,1,1502
Paulding Watson Govt Cmplx,Watson Govt Cmplx,164,2122,810,3,3099
Paulding East Paulding Middle Sch,East Paulding Middle Sch,228,3353,1780,2,5363
Paulding Events Place,Events Place,60,611,348,2,1021
Paulding Poplar Sprgs Bapt Church,Poplar Sprgs Bapt Church,59,703,370,1,1133
Paulding D Wright Innovation Ctr,D Wright Innovation Ctr,63,1478,672,1,2214
Paulding Taylor Farm Park,Taylor Farm Park,48,628,273,0,949
Paulding Nebo Elem School,Nebo Elem School,138,2253,1495,1,3887
Paulding White Oak Park,White Oak Park,76,1154,730,4,1964
Paulding Mulberry Rock Park,Mulberry Rock Park,123,1685,1248,2,3058
Paulding Beulahland Baptist Church,Beulahland Baptist Church,41,566,532,1,1140
Paulding Paulding County Airport,Paulding County Airport,85,899,854,6,1844
Paulding Dobbins Middle School,Dobbins Middle School,81,1466,631,1,2179
Peach Byron #1,Byron #1,19,855,332,0,1206
Peach Byron #2,Byron #2,63,1365,515,3,1946
Peach Claude,Claude,9,254,234,0,497
Peach Fort Valley #1,Fort Valley #1,38,320,198,0,556
Peach Fort Valley #2,Fort Valley #2,9,300,146,4,459
Peach Fort Valley #3,Fort Valley #3,4,171,59,0,234
Peach Powersville,Powersville,25,331,288,0,644
Pickens Yellow Creek,Yellow Creek,76,1196,754,0,2026
Pickens Sharptop,Sharptop,73,896,595,1,1565
Pickens Appalachian,Appalachian,30,631,339,0,1000
Pickens Refuge,Refuge,43,785,441,0,1269
Pickens Hill City,Hill City,34,643,492,0,1169
Pickens Hinton,Hinton,13,138,339,0,490
Pickens Jerusalem,Jerusalem,9,170,501,0,680
Pickens Ludville,Ludville,4,104,274,0,382
Pickens Nelson,Nelson,12,310,414,0,736
Pickens Talking Rock,Talking Rock,16,528,461,1,1006
Pickens Jasper,Jasper,45,763,402,0,1210
Pickens Tate,Tate,45,746,613,0,1404
Pierce Hacklebarney/Cason ,Hacklebarney/Cason ,40,950,414,0,1404
Pierce Blackshear,Blackshear,39,1113,485,0,1637
Pierce St. Johns/Blackshear,St. Johns/Blackshear,25,466,232,0,723
Pierce Otter Creek,Otter Creek,35,473,379,0,887
Pierce Patterson,Patterson,15,309,234,0,558
Pierce Mershon,Mershon,5,204,71,0,280
Pierce Alabaha,Alabaha,17,409,167,0,593
Pierce Sunset/Sweat,Sunset/Sweat,14,255,111,0,380
Pike Concord,Concord,17,368,429,0,814
Pike Hollonville,Hollonville,38,624,535,0,1197
Pike Meansville,Meansville,18,384,397,0,799
Pike Molena,Molena,11,422,453,1,887
Pike Second District,Second District,48,1010,562,0,1620
Pike Lifsey Springs,Lifsey Springs,23,345,327,1,696
Pike Williamson,Williamson,22,652,492,0,1166
Pike Zebulon,Zebulon,37,743,344,0,1124
Polk Aragon,Aragon,32,899,639,5,1575
Polk Blooming Grove,Blooming Grove,26,387,369,4,786
Polk Cedartown,Cedartown,110,1459,610,0,2179
Polk Fish Creek,Fish Creek,25,777,577,5,1384
Polk Lake Creek,Lake Creek,32,967,591,1,1591
Polk Rockmart,Rockmart,64,1632,826,6,2528
Polk Youngs Grove,Youngs Grove,29,566,472,7,1074
Pulaski Annex,Annex,106,1653,693,0,2452
Putnam 101,101,52,656,331,1,1040
Putnam 104,104,65,684,361,0,1110
Putnam 105,105,114,1492,786,1,2393
Putnam 106,106,23,422,384,0,829
Putnam 107,107,122,1357,837,1,2317
Quitman Georgetown,Georgetown,23,322,178,0,523
Quitman Morris,Morris,1,8,23,0,32
Rabun Rabun County,Rabun County,501,4755,1510,0,6766
Randolph Coleman,Coleman,5,45,52,0,102
Randolph Shellman,Shellman,10,108,186,1,305
Randolph Benevolence,Benevolence,3,55,62,0,120
Randolph Cuthbert-Courthouse,Cuthbert-Courthouse,16,446,195,0,657
Randolph Cuthbert,Cuthbert,1,4,2,0,7
Randolph Springvale,Springvale,7,16,29,0,52
Richmond 101,101,12,114,264,0,390
Richmond 102,102,6,49,64,0,119
Richmond 103,103,0,12,7,0,19
Richmond 104,104,11,44,47,0,102
Richmond 105,105,1,11,7,0,19
Richmond 106,106,5,27,69,0,101
Richmond 107,107,20,175,293,0,488
Richmond 108,108,3,12,20,0,35
Richmond 109,109,3,4,7,0,14
Richmond 110,110,0,8,14,0,22
Richmond 111,111,8,53,91,0,152
Richmond 112,112,37,89,73,0,199
Richmond 115,115,7,19,57,0,83
Richmond 201,201,11,85,150,0,246
Richmond 202,202,36,167,328,0,531
Richmond 203,203,2,4,7,0,13
Richmond 204,204,15,121,255,1,392
Richmond 207,207,13,42,38,0,93
Richmond 208,208,10,59,110,0,179
Richmond 210,210,7,43,63,0,113
Richmond 301,301,39,302,455,0,796
Richmond 302,302,11,54,49,0,114
Richmond 303,303,30,369,371,0,770
Richmond 304,304,12,136,153,0,301
Richmond 306,306,64,271,302,0,637
Richmond 307,307,37,272,350,0,659
Richmond 308,308,8,50,56,0,114
Richmond 310,310,33,228,348,0,609
Richmond 401,401,4,22,16,0,42
Richmond 402,402,10,43,57,0,110
Richmond 403,403,8,70,78,0,156
Richmond 405,405,12,130,108,0,250
Richmond 406,406,7,60,74,0,141
Richmond 501,501,14,73,76,0,163
Richmond 502,502,7,53,73,0,133
Richmond 503,503,11,96,80,0,187
Richmond 504,504,38,260,519,0,817
Richmond 505,505,5,56,23,0,84
Richmond 506,506,23,78,155,0,256
Richmond 507,507,3,39,53,0,95
Richmond 601,601,18,162,253,1,434
Richmond 602,602,2,11,26,0,39
Richmond 604,604,5,51,166,0,222
Richmond 605,605,32,215,341,0,588
Richmond 606,606,8,50,40,0,98
Richmond 607,607,11,54,74,1,140
Richmond 608,608,1,19,51,0,71
Richmond 701,701,41,438,529,0,1008
Richmond 702,702,20,197,343,0,560
Richmond 703,703,34,290,439,1,764
Richmond 704,704,20,122,118,0,260
Richmond 705,705,48,372,400,0,820
Richmond 706,706,51,824,469,0,1344
Richmond 707,707,17,249,261,0,527
Richmond 708,708,5,35,97,0,137
Richmond 709,709,10,91,73,0,174
Richmond 801,801,4,8,75,0,87
Richmond 801B,801B,6,18,186,0,210
Richmond 802,802,28,230,792,0,1050
Richmond 803,803,0,1,10,0,11
Richmond 804,804,16,156,254,0,426
Richmond 804H,804H,34,250,499,0,783
Richmond 805,805,6,39,91,1,137
Richmond 806,806,17,219,596,0,832
Richmond 807,807,7,67,112,0,186
Richmond 808,808,22,197,439,0,658
Richmond 810,810,3,60,104,0,167
Richmond 811,811,3,22,100,0,125
Rockdale BA,BA,51,557,378,1,987
Rockdale BT,BT,52,610,638,0,1300
Rockdale CO,CO,17,195,121,0,333
Rockdale FI,FI,24,285,112,0,421
Rockdale FS,FS,32,298,133,0,463
Rockdale HC,HC,21,316,222,0,559
Rockdale HI,HI,24,352,242,0,618
Rockdale LA,LA,13,135,105,0,253
Rockdale LO,LO,44,408,503,0,955
Rockdale MA,MA,33,349,353,0,735
Rockdale MI,MI,21,249,137,1,408
Rockdale OT,OT,28,249,107,1,385
Rockdale RO,RO,40,458,191,0,689
Rockdale SM,SM,26,357,201,2,586
Rockdale SP,SP,51,374,153,0,578
Rockdale ST,ST,58,452,157,1,668
Schley Precinct One,Precinct One,48,962,516,0,1526
Screven Sylvania,Sylvania,31,227,118,0,376
Screven Hunters,Hunters,5,73,112,0,190
Screven Newington,Newington,2,137,286,0,425
Screven Jenk Hill Fire Sta,Jenk Hill Fire Sta,8,188,147,0,343
Screven Rocky Ford,Rocky Ford,3,116,151,0,270
Screven Bay Branch,Bay Branch,10,266,246,0,522
Screven Hiltonia,Hiltonia,3,150,128,0,281
Screven Screven Rec Dept,Screven Rec Dept,6,57,51,0,114
Screven Greenhill Church,Greenhill Church,8,226,202,0,436
Screven Sr Citizens Center,Sr Citizens Center,7,185,64,0,256
Screven Jackson Fire Station,Jackson Fire Station,3,71,94,0,168
Screven Cooperville Fire Station,Cooperville Fire Station,0,13,28,0,41
Seminole Precinct 1,Precinct 1,21,240,315,0,576
Seminole Precinct 2,Precinct 2,19,210,185,0,414
Seminole Precinct 3,Precinct 3,1,31,39,0,71
Seminole Precinct 4,Precinct 4,12,176,305,1,494
Seminole Precinct 5,Precinct 5,15,216,469,0,700
Spalding 01,01,3,27,34,0,64
Spalding 02,02,7,34,30,0,71
Spalding 03,03,60,894,423,0,1377
Spalding 05,05,35,371,235,2,643
Spalding 06,06,15,133,67,0,215
Spalding 07,07,31,440,337,0,808
Spalding 08,08,31,464,315,0,810
Spalding 09,09,35,395,467,0,897
Spalding 10,10,24,415,334,0,773
Spalding 11,11,34,579,457,0,1070
Spalding 12,12,46,487,521,0,1054
Spalding 13,13,41,468,641,2,1152
Spalding 14,14,16,218,396,0,630
Spalding 16,16,46,312,234,2,594
Spalding 17,17,16,273,273,0,562
Spalding 19,19,54,543,482,0,1079
Spalding 20,20,26,500,527,1,1054
Spalding 21,21,157,1533,547,0,2237
Stephens Senior Center,Senior Center,370,5487,1961,0,7818
Stewart Richland,Richland,13,124,127,3,267
Stewart Louvale,Louvale,2,19,54,1,76
Stewart Lumpkin,Lumpkin,17,187,68,1,273
Stewart Omaha,Omaha,2,10,44,1,57
Sumter Agri-Center,Agri-Center,25,478,217,0,720
Sumter Airport,Airport,24,386,224,2,636
Sumter Andersonville,Andersonville,5,40,164,0,209
Sumter Browns Mill,Browns Mill,10,189,229,0,428
Sumter Concord,Concord,4,70,160,0,234
Sumter JROTC,JROTC,50,575,297,0,922
Sumter Leslie,Leslie,16,318,384,0,718
Sumter Plains,Plains,15,128,208,1,352
Sumter Rec Dept,Rec Dept,22,159,74,0,255
Sumter Rees Park,Rees Park,17,172,64,1,254
Sumter Thompson,Thompson,16,76,101,0,193
Talbot ONeal,ONeal,5,66,107,0,178
Talbot Valley,Valley,11,99,142,0,252
Talbot Junction City,Junction City,3,52,51,0,106
Talbot Geneva,Geneva,8,50,74,0,132
Talbot Talbotton,Talbotton,3,61,41,0,105
Talbot Box Springs,Box Springs,5,25,141,0,171
Talbot Flint Hill,Flint Hill,8,126,136,0,270
Taliaferro Sharon,Sharon,4,28,48,0,80
Taliaferro Crawfordville,Crawfordville,10,145,92,0,247
Tattnall Cobbtown,Cobbtown,13,122,218,0,353
Tattnall Collins,Collins,21,352,308,0,681
Tattnall District II,District II,13,557,252,1,823
Tattnall District IV,District IV,34,649,413,0,1096
Tattnall District V,District V,12,234,322,0,568
Tattnall East Glennville,East Glennville,57,648,435,0,1140
Tattnall Manassas,Manassas,5,74,106,0,185
Tattnall Shiloh,Shiloh,5,173,99,0,277
Taylor Precinct 1,Precinct 1,5,63,46,1,115
Taylor Precinct 5,Precinct 5,42,808,345,6,1201
Taylor Precinct 6,Precinct 6,29,489,303,0,821
Telfair Helena,Helena,12,195,156,0,363
Telfair Jacksonville,Jacksonville,20,117,185,0,322
Telfair Lumber-City,Lumber-City,10,116,190,0,316
Telfair McRae,McRae,45,489,244,0,778
Telfair Milan,Milan,25,194,269,0,488
Telfair Scotland,Scotland,0,50,116,0,166
Terrell Dawson ,Dawson ,30,219,111,0,360
Terrell Sasser,Sasser,17,267,316,0,600
Terrell Bronwood,Bronwood,10,117,145,0,272
Terrell Parrott,Parrott,5,51,142,0,198
Terrell Graves,Graves,19,95,142,0,256
Terrell Herod-Dover,Herod-Dover,1,31,77,0,109
Thomas Barwick,Barwick,7,169,170,0,346
Thomas Boston,Boston,11,266,207,0,484
Thomas Central,Central,45,997,434,0,1476
Thomas Coolidge,Coolidge,5,165,284,1,455
Thomas Douglass,Douglass,6,134,53,1,194
Thomas Little Ochlocknee Baptist,Little Ochlocknee Baptist,14,314,291,1,620
Thomas Fire Station #2,Fire Station #2,29,526,204,0,759
Thomas Gatlin Creek,Gatlin Creek,26,591,353,1,971
Thomas Harper,Harper,4,187,71,0,262
Thomas Jerger,Jerger,41,583,173,0,797
Thomas Meigs,Meigs,6,118,148,1,273
Thomas Merrillville,Merrillville,9,198,117,0,324
Thomas Metcalfe,Metcalfe,3,51,91,0,145
Thomas New Covenant,New Covenant,31,638,313,1,983
Thomas Ochlocknee,Ochlocknee,5,251,322,0,578
Thomas Pavo,Pavo,4,112,94,1,211
Thomas Patten,Patten,5,107,236,0,348
Thomas Remington Esc,Remington Esc,32,508,256,1,797
Thomas Resource Center,Resource Center,3,44,16,1,64
Thomas Scott,Scott,32,707,236,0,975
Tift Tifton NE,Tifton NE,35,720,291,3,1049
Tift Brighton,Brighton,30,821,492,1,1344
Tift Brookfield ,Brookfield ,10,369,373,0,752
Tift Chula,Chula,15,356,437,0,808
Tift Docia,Docia,11,344,325,0,680
Tift Eldorado,Eldorado,9,325,377,1,712
Tift Omega,Omega,1,89,254,0,344
Tift TY TY,TY TY,12,258,290,0,560
Tift Tifton NW,Tifton NW,42,954,447,0,1443
Tift Tifton South,Tifton South,14,231,89,0,334
Tift Mott-Litman Gym,Mott-Litman Gym,7,145,60,0,212
Tift Tifton Lodge ,Tifton Lodge ,38,782,360,0,1180
Toombs 15361 Lyons,15361 Lyons,60,856,446,0,1362
Toombs 39 Newbranch,39 Newbranch,24,397,407,1,829
Toombs 43 Cedar Crossing,43 Cedar Crossing,26,307,433,0,766
Toombs 513 VPD,513 VPD,109,1464,689,1,2263
Toombs 514 STIALC,514 STIALC,59,827,416,0,1302
Towns Young Harris,Young Harris,91,1064,653,3,1811
Towns Hiawassee,Hiawassee,235,3021,997,2,4255
Treutlen Annex,Annex,29,678,386,2,1095
Treutlen Soperton,Soperton,36,364,269,0,669
Troup Hollis Hand,Hollis Hand,109,1011,689,2,1811
Troup Administration Bldg,Administration Bldg,32,225,180,0,437
Troup Hammett Rd,Hammett Rd,47,357,335,0,739
Troup Griggs Center,Griggs Center,7,36,25,0,68
Troup West Point,West Point,11,72,243,0,326
Troup Hogansville,Hogansville,45,556,876,0,1477
Troup East Vernon,East Vernon,59,765,846,2,1672
Troup Rosemont,Rosemont,74,1100,992,2,2168
Troup McClendon,McClendon,55,823,848,0,1726
Troup Long Cane,Long Cane,38,549,863,1,1451
Troup Gardner Newman,Gardner Newman,37,502,399,1,939
Troup Gray Hill,Gray Hill,16,237,532,2,787
Troup Highland,Highland,17,222,159,0,398
Troup Northside,Northside,47,511,307,0,865
Turner Ashburn,Ashburn,12,283,135,0,430
Turner Sycamore,Sycamore,16,665,290,1,972
Turner Rebecca,Rebecca,5,356,230,1,592
Twiggs Dry Branch,Dry Branch,16,187,391,0,594
Twiggs Golden Isles,Golden Isles,13,155,234,0,402
Twiggs Higgsville,Higgsville,12,140,208,0,360
Twiggs Jeffersonville-Ware,Jeffersonville-Ware,10,179,154,0,343
Twiggs Shady Grove-Tarvers,Shady Grove-Tarvers,7,135,139,0,281
Union Blairsville,Blairsville,64,857,407,0,1328
Union Coosa,Coosa,47,835,557,0,1439
Union Choestoe,Choestoe,54,421,418,0,893
Union Jones Creek,Jones Creek,39,628,598,1,1266
Union Owltown,Owltown,38,546,343,0,927
Union Ivy Log,Ivy Log,53,761,568,1,1383
Union Suches,Suches,13,73,274,0,360
Union Trackrock,Trackrock,29,403,264,0,696
Union Dooley,Dooley,24,491,476,0,991
Union Gumlog,Gumlog,47,791,523,1,1362
Union Pat Colwell,Pat Colwell,73,910,495,0,1478
Upson Yatesville,Yatesville,9,256,453,0,718
Upson Salem,Salem,2,21,19,1,43
Upson Redbone,Redbone,160,2583,1140,1,3884
Upson Town,Town,117,1635,699,0,2451
Walker La Fayette,La Fayette,111,1334,1123,3,2571
Walker Walnut Grove,Walnut Grove,30,468,597,0,1095
Walker Rock Spring,Rock Spring,115,1807,1217,1,3140
Walker Armuchee Valley,Armuchee Valley,11,133,618,2,764
Walker Mountain,Mountain,17,138,445,1,601
Walker Chattanooga Valley,Chattanooga Valley,140,1309,1285,2,2736
Walker Kensington,Kensington,13,161,449,0,623
Walker Rossville,Rossville,82,1066,789,0,1937
Walker Chickamauga,Chickamauga,100,1936,1265,0,3301
Walker Fairyland,Fairyland,20,255,334,0,609
Walker Fairview,Fairview,46,461,528,2,1037
Walton Bold Springs,Bold Springs,78,1254,1280,1,2613
Walton Whatley,Whatley,37,509,391,0,937
Walton Walker Park,Walker Park,89,1064,923,0,2076
Walton Gratis,Gratis,31,379,459,0,869
Walton Between,Between,69,1537,1177,0,2783
Walton Walnut Grove,Walnut Grove,25,634,643,0,1302
Walton Loganvile North,Loganvile North,85,1138,700,0,1923
Walton Social Circle,Social Circle,56,1255,777,0,2088
Walton South Monroe,South Monroe,72,1027,490,0,1589
Walton North Monroe,North Monroe,40,540,475,0,1055
Walton Loganville South,Loganville South,71,851,510,0,1432
Walton West Walton,West Walton,59,1160,852,1,2072
Walton Broken Arrow,Broken Arrow,68,1091,872,0,2031
Walton Bay Creek,Bay Creek,60,1044,616,1,1721
Walton E Monroe,E Monroe,46,622,557,0,1225
Walton W Monroe,W Monroe,31,689,459,2,1181
Walton Tara,Tara,42,845,448,0,1335
Walton Mountain,Mountain,45,390,518,0,953
Walton Jersey,Jersey,24,497,709,0,1230
Walton Blasingame,Blasingame,20,263,439,1,723
Walton Good Hope,Good Hope,40,529,860,0,1429
Ware 100 - City Auditorium,100 - City Auditorium,35,289,131,0,455
Ware 200A - Memorial Stadium,200A - Memorial Stadium,90,1158,355,0,1603
Ware 200B - City Auditorium,200B - City Auditorium,31,247,68,0,346
Ware 300 - Ware BoE Transportation,300 - Ware BoE Transportation,102,889,526,1,1518
Ware 304 - Ware BoE Learning Center,304 - Ware BoE Learning Center,15,189,188,0,392
Ware 400 - Second Baptist Church,400 - Second Baptist Church,8,229,603,0,840
Ware 404 - Bickley UM Church,404 - Bickley UM Church,9,68,173,1,251
Ware 405 - Haywood Baptist Church,405 - Haywood Baptist Church,6,112,246,0,364
Ware 406 - Jamestown Baptist Church,406 - Jamestown Baptist Church,23,394,433,0,850
Ware 407 - Manor Commmunity Center,407 - Manor Commmunity Center,12,98,250,0,360
Ware 408 - Millwood Baptist Church,408 - Millwood Baptist Church,2,56,230,1,289
Ware 409 - Waresboro Church of God,409 - Waresboro Church of God,15,257,315,0,587
Warren Warrenton,Warrenton,62,667,334,0,1063
Washington Riddleville,Riddleville,8,90,153,0,251
Washington Warthen,Warthen,8,96,179,0,283
Washington Tennille,Tennille,32,360,262,1,655
Washington Oconee,Oconee,9,59,143,0,211
Washington Harrison,Harrison,16,166,240,1,423
Washington Davisboro,Davisboro,19,119,181,0,319
Washington Sandersville,Sandersville,107,1068,503,0,1678
Washington Deepstep,Deepstep,8,63,207,0,278
Wayne Odum,Odum,17,305,486,1,809
Wayne Madray Springs,Madray Springs,23,364,335,0,722
Wayne Oglethorpe,Oglethorpe,29,498,388,0,915
Wayne Screven,Screven,23,391,585,0,999
Wayne Empire,Empire,22,286,308,0,616
Wayne Red Hill,Red Hill,12,219,190,0,421
Wayne Altamaha,Altamaha,39,686,327,0,1052
Wayne Gardi,Gardi,28,229,368,0,625
Wayne VFW,VFW,11,64,49,0,124
Wayne Pine Street,Pine Street,19,226,123,0,368
Wayne Unity,Unity,48,409,297,0,754
Wayne Rec Center,Rec Center,31,348,386,0,765
Webster Preston 1,Preston 1,65,423,220,0,708
Wheeler Alamo,Alamo,30,411,334,2,777
Wheeler Glenwood,Glenwood,16,240,285,0,541
White Blue Creek,Blue Creek,66,677,549,0,1292
White Blue Ridge,Blue Ridge,23,297,254,0,574
White Robertstown-Helen,Robertstown-Helen,18,229,243,0,490
White Mossy Creek,Mossy Creek,60,863,831,1,1755
White Mt Yonah,Mt Yonah,106,1412,747,1,2266
White Nacoochee,Nacoochee,46,463,283,0,792
White Shoal Creek,Shoal Creek,42,623,609,0,1274
White Tesnatee,Tesnatee,35,391,251,0,677
White Town Creek,Town Creek,35,419,417,0,871
White White Creek,White Creek,49,496,463,0,1008
Whitefield 1A,1A,40,213,200,0,453
Whitefield 2A,2A,36,661,541,1,1239
Whitefield 3A,3A,31,420,442,0,893
Whitefield 4A,4A,25,530,482,1,1038
Whitefield 5A,5A,6,60,150,0,216
Whitefield 6A,6A,6,69,82,0,157
Whitefield AN,AN,11,154,271,0,436
Whitefield CA,CA,18,194,542,1,755
Whitefield CO,CO,9,159,535,2,705
Whitefield DG,DG,50,462,797,1,1310
Whitefield ES,ES,13,173,302,0,488
Whitefield FI,FI,28,224,497,0,749
Whitefield GL,GL,30,363,508,1,902
Whitefield LT,LT,23,237,399,1,660
Whitefield MC,MC,13,261,606,1,881
Whitefield NI,NI,22,339,797,1,1159
Whitefield PG,PG,84,810,989,0,1883
Whitefield TH,TH,45,565,1038,2,1650
Whitefield TI,TI,1,56,249,1,307
Whitefield TR,TR,22,264,520,0,806
Whitefield UT,UT,7,135,415,0,557
Whitefield VA,VA,63,861,1446,6,2376
Whitefield WS,WS,41,527,730,1,1299
Wilcox Rochelle North #1,Rochelle North #1,3,25,34,0,62
Wilcox Abbeville North #2,Abbeville North #2,3,75,54,0,132
Wilcox Pineview #2,Pineview #2,8,65,160,0,233
Wilcox Pitts #3,Pitts #3,8,147,310,0,465
Wilcox Rochelle South #4,Rochelle South #4,18,236,306,0,560
Wilcox Abbeville South #5,Abbeville South #5,34,329,183,0,546
Wilkes Senior Citizen Center,Senior Citizen Center,20,209,120,0,349
Wilkes Young Famer's Bldg,Young Famer's Bldg,21,362,270,0,653
Wilkes Metasville Fire Sta,Metasville Fire Sta,10,129,180,0,319
Wilkes Edward B Pope Center,Edward B Pope Center,7,94,67,0,168
Wilkes Rayle City Hall,Rayle City Hall,1,68,175,0,244
Wilkes Courthouse,Courthouse,16,317,109,1,443
Wilkes Tignall Sch Lunch Rm,Tignall Sch Lunch Rm,7,120,242,0,369
Wilkenson Bloodworth,Bloodworth,5,65,229,0,299
Wilkenson Griffin,Griffin,4,23,87,0,114
Wilkenson High Hill,High Hill,1,19,83,0,103
Wilkenson Irwinton,Irwinton,10,130,119,0,259
Wilkenson Ivey,Ivey,20,95,339,0,454
Wilkenson Lord,Lord,12,79,184,0,275
Wilkenson Midway,Midway,7,48,54,0,109
Wilkenson Ramah,Ramah,21,155,353,0,529
Wilkenson Turkey Creek,Turkey Creek,6,44,174,0,224
Worth Sylvester ,Sylvester ,16,312,219,1,548
Worth Scooterville ,Scooterville ,3,88,274,0,365
Worth Minton,Minton,16,259,352,1,628
Worth Bridgeboro,Bridgeboro,8,156,247,0,411
Worth County Line,County Line,7,120,204,0,331
Worth Isabella ,Isabella ,13,243,268,0,524
Worth Sylvester East,Sylvester East,20,418,405,2,845
Worth Poulan ,Poulan ,6,177,278,0,461
Worth Sumner,Sumner,8,160,292,1,461
Worth Red Rock,Red Rock,10,144,325,0,479
Worth Doles,Doles,4,72,145,1,222
Worth Warwick,Warwick,8,83,283,0,374
