ID,Counties,Absentee by Mail Votes,Advance Voting Votes,Election Day Votes,Provisional Votes,Total
Appling 1B,1B,40,327,354,0,721
Appling 1C,1C,19,300,252,0,571
Appling 2,2,23,181,189,0,393
Appling 3A1,3A1,16,198,279,0,493
Appling 3C,3C,35,411,280,0,726
Appling 4B,4B,17,209,365,1,592
Appling 4D,4D,43,420,332,0,795
Appling 5A,5A,21,269,253,0,543
Appling 5B,5B,10,235,265,0,510
Atkinson Pearson County,Pearson County,15,503,312,1,831
Atkinson Axson,Axson,6,86,249,0,341
Atkinson Willacoochee,Willacoochee,9,152,249,1,411
Atkinson Pearson City,Pearson City,3,66,56,1,126
Bacon Douglas,Douglas,74,2301,829,0,3204
Baker Anna,Anna,5,45,90,0,140
Baker Elmodel,Elmodel,11,74,52,0,137
Baker Hoggards Mill,Hoggards Mill,3,40,60,1,104
Baker Milford,Milford,12,83,103,0,198
Baker Newton,Newton,4,80,47,1,132
Baldwin Scottboro,Scottboro,16,145,171,0,332
Baldwin North Baldwin,North Baldwin,65,1075,540,0,1680
Baldwin West Baldwin,West Baldwin,15,367,266,0,648
Baldwin East Hardwick,East Hardwick,3,37,42,0,82
Baldwin West Hardwick,West Hardwick,15,184,102,0,301
Baldwin Coopers,Coopers,11,274,369,0,654
Baldwin South Milledgeville,South Milledgeville,5,63,37,0,105
Baldwin City Hall Annex,City Hall Annex,7,38,32,0,77
Baldwin Boddie,Boddie,1,62,31,0,94
Baldwin Courthouse,Courthouse,5,45,24,0,74
Baldwin West Thomas,West Thomas,9,89,44,0,142
Baldwin North Milledgeville,North Milledgeville,26,434,187,0,647
Baldwin Meriwether,Meriwether,56,746,407,0,1209
Baldwin East Baldwin,East Baldwin,62,844,465,0,1371
Banks Anderson,Anderson,15,452,271,0,738
Banks Baldwin,Baldwin,38,239,145,0,422
Banks Berlin,Berlin,6,182,115,0,303
Banks Bushville,Bushville,8,260,160,0,428
Banks Columbia,Columbia,6,127,76,0,209
Banks Davids,Davids,17,489,356,1,863
Banks Golden Hill,Golden Hill,11,256,138,3,408
Banks Grove River,Grove River,15,181,129,0,325
Banks Hollingsworth,Hollingsworth,14,215,120,0,349
Banks Homer,Homer,11,468,259,0,738
Banks Poplar Springs,Poplar Springs,41,564,282,0,887
Banks Washington,Washington,8,246,116,1,371
Banks Wilmonts,Wilmonts,5,208,108,0,321
Barrow 01,01,34,591,698,0,1323
Barrow 02,02,129,1714,1404,1,3248
Barrow 03,03,76,936,1227,0,2239
Barrow 04,04,32,655,639,0,1326
Barrow 05,05,113,1764,1471,1,3349
Barrow 08,08,98,1880,1075,0,3053
Barrow 13,13,115,1729,1161,1,3006
Barrow 16,16,71,1262,1259,0,2592
Bartow Adairsville,Adairsville,75,1543,1294,3,2915
Bartow Allatoona,Allatoona,32,728,656,1,1417
Bartow Cartersville East,Cartersville East,111,1201,765,2,2079
Bartow Cartersville West,Cartersville West,119,2175,1065,1,3360
Bartow Cassville,Cassville,62,867,579,0,1508
Bartow Center,Center,67,925,927,1,1920
Bartow Emerson,Emerson,42,531,676,1,1250
Bartow Euharlee,Euharlee,45,1010,1177,2,2234
Bartow Folsom,Folsom,17,226,461,1,705
Bartow Kingston,Kingston,28,491,762,0,1281
Bartow Mission Road,Mission Road,62,905,630,2,1599
Bartow Pine Log,Pine Log,28,379,759,2,1168
Bartow Taylorsville,Taylorsville,25,469,1013,0,1507
Bartow White,White,37,562,760,1,1360
Bartow Zena Drive,Zena Drive,82,944,668,4,1698
Bartow Hamilton Crossing,Hamilton Crossing,100,1530,1035,2,2667
Bartow Woodland,Woodland,41,297,353,2,693
Ben Hill East,East,67,2266,900,2,3235
Berrien West Berrien,West Berrien,23,174,383,0,580
Berrien Ray City ,Ray City ,22,373,386,0,781
Berrien Nashville,Nashville,100,1692,870,0,2662
Berrien Enigma,Enigma,8,98,364,0,470
Berrien Alapaha ,Alapaha ,13,161,334,1,509
Bibb East Macon 1,East Macon 1,2,8,6,1,17
Bibb East Macon 2,East Macon 2,8,40,30,0,78
Bibb East Macon 3,East Macon 3,31,198,181,0,410
Bibb East Macon 4,East Macon 4,3,21,28,0,52
Bibb East Macon 5,East Macon 5,14,104,142,0,260
Bibb Godfrey 1,Godfrey 1,17,74,84,1,176
Bibb Godfrey 2,Godfrey 2,5,22,26,0,53
Bibb Godfrey 3,Godfrey 3,9,50,26,2,87
Bibb Godfrey 4,Godfrey 4,6,33,26,0,65
Bibb Godfrey 5,Godfrey 5,20,75,88,0,183
Bibb Hazzard 1,Hazzard 1,12,60,60,0,132
Bibb Hazzard 2,Hazzard 2,39,268,582,0,889
Bibb Hazzard 3,Hazzard 3,47,445,371,1,864
Bibb Hazzard 4,Hazzard 4,76,783,910,4,1773
Bibb Howard 1,Howard 1,102,730,621,1,1454
Bibb Howard 2,Howard 2,93,686,673,3,1455
Bibb Howard 3,Howard 3,89,856,855,2,1802
Bibb Howard 4,Howard 4,23,239,158,0,420
Bibb Howard 5,Howard 5,23,144,199,0,366
Bibb Howard 6,Howard 6,40,358,261,0,659
Bibb Howard 7,Howard 7,40,506,556,0,1102
Bibb Rutland 1,Rutland 1,83,690,1189,0,1962
Bibb Rutland 2,Rutland 2,51,360,811,0,1222
Bibb Vineville 1,Vineville 1,17,188,256,0,461
Bibb Vineville 2,Vineville 2,6,82,113,1,202
Bibb Vineville 3,Vineville 3,11,61,34,0,106
Bibb Vineville 4,Vineville 4,11,90,87,0,188
Bibb Vineville 5,Vineville 5,49,317,322,0,688
Bibb Vineville 6,Vineville 6,18,320,372,0,710
Bibb Warrior 1,Warrior 1,40,262,784,3,1089
Bibb Warrior 2,Warrior 2,41,441,796,0,1278
Bleckley 1,1,140,2137,1397,1,3675
Brantley Hoboken,Hoboken,33,797,878,0,1708
Brantley Nahunta,Nahunta,48,1088,773,0,1909
Brantley Waynesville,Waynesville,15,696,947,0,1658
Brooks Quitman ,Quitman ,28,457,263,1,749
Brooks Barwick,Barwick,2,38,121,0,161
Brooks Dixie,Dixie,4,136,159,2,301
Brooks Briggs,Briggs,25,372,519,0,916
Brooks Pavo,Pavo,2,71,205,0,278
Brooks Nankin,Nankin,4,132,201,0,337
Brooks Morven,Morven,12,326,444,4,786
Bryan Harn Community Center,Harn Community Center,13,499,293,0,805
Bryan Danielsiding,Danielsiding,20,517,320,0,857
Bryan Christ Baptist Church,Christ Baptist Church,29,787,587,0,1403
Bryan Black Creek,Black Creek,17,242,315,0,574
Bryan First Baptist Church,First Baptist Church,23,604,391,0,1018
Bryan RH Rec Complex,RH Rec Complex,20,482,232,0,734
Bryan John Stevens Wetland Ctr,John Stevens Wetland Ctr,48,1043,327,0,1418
Bryan New Life,New Life,23,1232,578,0,1833
Bryan New Beginnings,New Beginnings,34,927,451,0,1412
Bryan Bryan County Admin Bldg,Bryan County Admin Bldg,20,662,407,0,1089
Bulloch Lockhart,Lockhart,4,81,248,1,334
Bulloch Emit,Emit,35,615,665,0,1315
Bulloch Statesboro,Statesboro,86,934,574,0,1594
Bulloch Portal,Portal,13,219,456,1,689
Bulloch Fair,Fair,93,1254,691,5,2043
Bulloch Church,Church,65,803,509,3,1380
Bulloch Pittman Park,Pittman Park,30,296,249,2,577
Bulloch Leefield,Leefield,10,114,385,1,510
Bulloch Blitch,Blitch,19,400,545,0,964
Bulloch Hagin,Hagin,24,336,543,0,903
Bulloch Brooklet,Brooklet,35,666,870,2,1573
Bulloch Stilson,Stilson,14,275,700,0,989
Bulloch Bay,Bay,19,211,578,1,809
Bulloch Nevils,Nevils,18,208,398,0,624
Bulloch Sinkhole,Sinkhole,7,52,185,0,244
Bulloch Register,Register,9,116,184,1,310
Burke Alexander,Alexander,2,34,92,0,128
Burke Four Points,Four Points,23,294,541,0,858
Burke Girard,Girard,17,57,123,0,197
Burke Gough,Gough,4,40,56,0,100
Burke Greenscut,Greenscut,11,144,189,0,344
Burke Keysville,Keysville,2,23,76,0,101
Burke Midville,Midville,2,20,86,0,108
Burke Munnerlyn,Munnerlyn,1,35,57,0,93
Burke Sardis,Sardis,8,70,237,0,315
Burke Scotts Crossroads,Scotts Crossroads,0,14,41,0,55
Burke Telfair,Telfair,8,88,191,0,287
Burke St Clair,St Clair,7,68,100,0,175
Burke Vidette,Vidette,2,15,74,2,93
Burke North Waynesboro,North Waynesboro,17,265,111,0,393
Burke South Waynesboro,South Waynesboro,37,636,397,1,1071
Burke Blakeney,Blakeney,1,74,69,0,144
Butts Butts County Recreation Center,Butts County Recreation Center,61,1138,282,0,1481
Butts Jenkinsburg City Hall,Jenkinsburg City Hall,31,977,325,0,1333
Butts Rock Creek Missionary,Rock Creek Missionary,16,417,155,1,589
Butts Stark United Methodist Church,Stark United Methodist Church,45,1215,513,0,1773
Butts Towaliga Baptist Church,Towaliga Baptist Church,42,1179,386,1,1608
Calhoun Leary ,Leary ,6,116,83,0,205
Calhoun Morgan,Morgan,18,119,117,0,254
Calhoun Edison ,Edison ,2,13,33,0,48
Calhoun Edison-Arlington,Edison-Arlington,2,69,70,0,141
Calhoun Arlington,Arlington,1,42,33,0,76
Camden Tarboro,Tarboro,6,156,243,0,405
Camden Waverly,Waverly,30,360,398,1,789
Camden Woodbine,Woodbine,16,297,344,0,657
Camden Browntown,Browntown,5,112,159,0,276
Camden Harriets Bluff,Harriets Bluff,20,394,435,0,849
Camden West Kingsland,West Kingsland,18,560,365,0,943
Camden North Kingsland,North Kingsland,6,285,215,0,506
Camden Kingsland,Kingsland,10,298,199,0,507
Camden East Kingsland,East Kingsland,58,1401,779,2,2240
Camden North St. Marys,North St. Marys,19,152,166,0,337
Camden St. Marys ,St. Marys ,17,394,411,0,822
Camden South St. Marys,South St. Marys,32,452,326,0,810
Camden Mush Bluff,Mush Bluff,19,502,426,0,947
Camden West St. Marys ,West St. Marys ,77,1044,489,0,1610
Candler JSCC,JSCC,51,1764,735,2,2552
Carroll Kansas,Kansas,15,159,485,0,659
Carroll Bowdon,Bowdon,25,406,789,0,1220
Carroll Sandhill,Sandhill,37,815,731,0,1583
Carroll Center Point,Center Point,36,436,592,0,1064
Carroll Mt Zion,Mt Zion,15,381,745,1,1142
Carroll Burwell,Burwell,21,240,453,1,715
Carroll Clem,Clem,28,952,736,1,1717
Carroll Bowdon Junction,Bowdon Junction,13,294,346,0,653
Carroll Tyus,Tyus,15,282,727,0,1024
Carroll Fairfield,Fairfield,27,647,1058,0,1732
Carroll Hulett,Hulett,20,504,657,0,1181
Carroll Bethany,Bethany,22,657,512,0,1191
Carroll V R County South,V R County South,20,686,444,0,1150
Carroll V R County North,V R County North,32,953,708,0,1693
Carroll Villa Rica City,Villa Rica City,49,792,507,0,1348
Carroll Temple County,Temple County,42,714,806,0,1562
Carroll Temple City,Temple City,21,390,696,1,1108
Carroll Whitesburg,Whitesburg,21,334,666,1,1022
Carroll Roopville,Roopville,21,689,935,0,1645
Carroll West Carrollton,West Carrollton,20,386,197,0,603
Carroll Lakeshore Rec Center,Lakeshore Rec Center,21,290,147,0,458
Carroll Bonner,Bonner,31,774,369,0,1174
Carroll University of W GA,University of W GA,7,361,187,0,555
Carroll County Admin Bldg,County Admin Bldg,18,501,236,1,756
Carroll Tabernacle Church,Tabernacle Church,41,353,211,0,605
Carroll Burson Center,Burson Center,3,325,180,0,508
Carroll Old Camp Church,Old Camp Church,16,518,488,0,1022
Carroll Oak Grove,Oak Grove,14,294,440,0,748
Catoosa Blackstock,Blackstock,17,338,493,0,848
Catoosa Boynton,Boynton,71,1523,1009,2,2605
Catoosa Catoosa Keith,Catoosa Keith,23,559,605,0,1187
Catoosa Chambers,Chambers,19,781,598,0,1398
Catoosa Ft Oglethorpe,Ft Oglethorpe,37,796,549,2,1384
Catoosa Graysville,Graysville,38,906,793,3,1740
Catoosa Lakeview,Lakeview,24,623,420,0,1067
Catoosa Poplar Springs,Poplar Springs,43,1088,696,3,1830
Catoosa Ringgold,Ringgold,72,1950,974,1,2997
Catoosa Westside,Westside,55,1400,625,2,2082
Catoosa Woodstation,Woodstation,17,659,747,1,1424
Charlton Folkston,Folkston,29,884,490,2,1405
Charlton GA Bend,GA Bend,7,19,201,1,228
Charlton St. George ,St. George ,10,42,214,1,267
Charlton Homeland,Homeland,7,171,165,1,344
Charlton Racepond,Racepond,1,58,104,0,163
Charlton Winokur,Winokur,6,53,86,0,145
Chatham 1-01C First Presbyterian Church,1-01C First Presbyterian Church,44,264,443,1,752
Chatham 1-05C JEA Building,1-05C JEA Building,27,146,285,0,458
Chatham 1-06C Central Church of Christ,1-06C Central Church of Christ,48,231,381,0,660
Chatham 1-08C Grace United Methodist Church,1-08C Grace United Methodist Church,19,147,331,0,497
Chatham 1-09C Immanuel Baptist Church,1-09C Immanuel Baptist Church,11,92,130,0,233
Chatham 1-10C St Thomas Episcopal Church,1-10C St Thomas Episcopal Church,21,120,408,0,549
Chatham 1-12C Isle of Hope Baptist,1-12C Isle of Hope Baptist,36,380,532,0,948
Chatham 1-13C The Sanctuary,1-13C The Sanctuary,15,167,275,0,457
Chatham 1-14C St. Luke United Methodist Church,1-14C St. Luke United Methodist Church,43,306,329,0,678
Chatham 1-16C Ferguson Ave Baptist,1-16C Ferguson Ave Baptist,37,446,811,0,1294
Chatham 1-17C Islands Christian Church,1-17C Islands Christian Church,74,804,551,0,1429
Chatham 2-02C River Pointe,2-02C River Pointe,7,59,60,0,126
Chatham 2-03C W W Law Center,2-03C W W Law Center,2,33,53,0,88
Chatham 2-04C Fellowship of Love Church,2-04C Fellowship of Love Church,1,27,47,0,75
Chatham 2-05C Holy Spirit Lutheran Church,2-05C Holy Spirit Lutheran Church,3,36,59,0,98
Chatham 2-06C Eli Whitney Complex - Savannah,2-06C Eli Whitney Complex - Savannah,2,15,31,0,48
Chatham 2-06C Eli Whitney Complex,2-06C Eli Whitney Complex,17,158,83,0,258
Chatham 2-07C Christ Community Church,2-07C Christ Community Church,12,64,88,0,164
Chatham 2-09C Salvation Army,2-09C Salvation Army,10,69,111,0,190
Chatham 2-11C Oasis of Hope,2-11C Oasis of Hope,6,43,41,0,90
Chatham 2-12C Williams Court Apts,2-12C Williams Court Apts,4,16,64,0,84
Chatham 3-02C Temple Mickve Israel,3-02C Temple Mickve Israel,17,174,135,1,327
Chatham 3-03C Savannah High School,3-03C Savannah High School,3,20,21,0,44
Chatham 3-04C First African Baptist Church,3-04C First African Baptist Church,1,16,15,0,32
Chatham 3-05C New Generations Cathedral,3-05C New Generations Cathedral,8,67,109,0,184
Chatham 3-08C Jenkins High School,3-08C Jenkins High School,8,63,95,0,166
Chatham 3-09C The Connexion Church,3-09C The Connexion Church,14,49,186,0,249
Chatham 3-10C Bible Baptist Church,3-10C Bible Baptist Church,6,46,103,0,155
Chatham 3-11C Southside Baptist Church,3-11C Southside Baptist Church,3,41,67,0,111
Chatham 3-12C Thunderbolt Muni Complex,3-12C Thunderbolt Muni Complex,15,114,272,0,401
Chatham 3-13C New Cov 7 Day Adv Ch,3-13C New Cov 7 Day Adv Ch,21,189,213,0,423
Chatham 3-14C Oglethorpe Charter Academy,3-14C Oglethorpe Charter Academy,18,117,97,1,233
Chatham 3-14C Oglethorpe Charter Academy - Savannah,3-14C Oglethorpe Charter Academy - Savannah,1,17,13,0,31
Chatham 4-02C Islands High School Annex,4-02C Islands High School Annex,23,384,394,0,801
Chatham 4-04C Lighthouse Baptist Church,4-04C Lighthouse Baptist Church,26,382,553,0,961
Chatham 4-05C St Francis Episcopal Church,4-05C St Francis Episcopal Church,29,396,483,0,908
Chatham 4-06C First Baptist of the Island,4-06C First Baptist of the Island,30,513,494,0,1037
Chatham 4-07C Wilmington Island UMC,4-07C Wilmington Island UMC,41,604,572,0,1217
Chatham 4-08C Wilmington Island Pres Church,4-08C Wilmington Island Pres Church,54,574,621,0,1249
Chatham 4-10C Burke Day Public Safety BLDG,4-10C Burke Day Public Safety BLDG,19,195,322,1,537
Chatham 4-11C Island Old School Cafe,4-11C Island Old School Cafe,19,175,430,1,625
Chatham 4-12C St Peters Episcopal,4-12C St Peters Episcopal,49,384,779,1,1213
Chatham 4-13C Skidaway Community Church,4-13C Skidaway Community Church,87,443,719,0,1249
Chatham 4-14C Skidaway Island Methodist Church,4-14C Skidaway Island Methodist Church,121,723,971,1,1816
Chatham 5-02C Senior Citizens Center,5-02C Senior Citizens Center,3,13,21,0,37
Chatham 5-03C Butler Presbyterian Church,5-03C Butler Presbyterian Church,0,3,8,0,11
Chatham 5-05C Liberty City Comm Ctr,5-05C Liberty City Comm Ctr,1,11,25,0,37
Chatham 5-06C Seed Church,5-06C Seed Church,2,23,42,0,67
Chatham 5-06C Seed Church - Savannah,5-06C Seed Church - Savannah,4,13,28,0,45
Chatham 5-07C Elks Lodge,5-07C Elks Lodge,5,55,101,0,161
Chatham 5-08C Savannah Primitive BC,5-08C Savannah Primitive BC,9,89,120,0,218
Chatham 5-10C Jonesville Baptist Church,5-10C Jonesville Baptist Church,5,17,26,0,48
Chatham 5-11C Largo-Tibet Elementary,5-11C Largo-Tibet Elementary,44,133,73,0,250
Chatham 6-01C White Bluff Presbyterian,6-01C White Bluff Presbyterian,14,121,165,0,300
Chatham 6-02C Windsor Forest Baptist - Savannah,6-02C Windsor Forest Baptist - Savannah,31,339,395,0,765
Chatham 6-02C Windsor Forest Baptist,6-02C Windsor Forest Baptist,3,32,28,0,63
Chatham 6-03C Crusader Comm Center,6-03C Crusader Comm Center,29,303,285,0,617
Chatham 6-05C Windsor Hall,6-05C Windsor Hall,17,136,154,0,307
Chatham 6-06C The Light Church,6-06C The Light Church,23,154,140,0,317
Chatham 6-08C Christ Memorial Baptist Church,6-08C Christ Memorial Baptist Church,15,97,92,0,204
Chatham 6-09C Trinity Lutheran Church,6-09C Trinity Lutheran Church,34,356,293,0,683
Chatham 6-10C Georgetown Elementary,6-10C Georgetown Elementary,27,536,438,0,1001
Chatham 6-10C Georgetown Elementary - Savannah,6-10C Georgetown Elementary - Savannah,3,16,22,0,41
Chatham 6-11C Coastal GA Botanical Gardens,6-11C Coastal GA Botanical Gardens,16,168,184,0,368
Chatham 6-11C Coastal GA Botanical Gardens - Savannah,6-11C Coastal GA Botanical Gardens - Savannah,12,122,144,0,278
Chatham 7-01C First Baptist Church of Garden City,7-01C First Baptist Church of Garden City,11,121,229,0,361
Chatham 7-03C PB Edwards Gym,7-03C PB Edwards Gym,12,69,282,0,363
Chatham 7-04C Lake Shore Comm Ctr,7-04C Lake Shore Comm Ctr,6,63,196,1,266
Chatham 7-05C Woodlawn Baptist Church,7-05C Woodlawn Baptist Church,8,75,136,0,219
Chatham 7-06C 1st Baptist Church of Pooler,7-06C 1st Baptist Church of Pooler,34,337,313,1,685
Chatham 7-07C Rothwell Baptist Church,7-07C Rothwell Baptist Church,56,572,560,0,1188
Chatham 7-08C Bloomingdale Comm Ctr,7-08C Bloomingdale Comm Ctr,21,254,745,0,1020
Chatham 7-08C Bloomingdale Comm Ctr - Savannah,7-08C Bloomingdale Comm Ctr - Savannah,2,7,13,0,22
"Chatham 7-09C Compassion Christian, Henderson","7-09C Compassion Christian, Henderson",20,212,250,0,482
"Chatham 7-09C Compassion Christian, Henderson - Savannah","7-09C Compassion Christian, Henderson - Savannah",0,0,0,0,0
Chatham 7-10C Progressive Rec Center,7-10C Progressive Rec Center,39,271,266,0,576
Chatham 7-11C Savannah Fire Station 14,7-11C Savannah Fire Station 14,19,134,209,0,362
Chatham 7-12C West Chatham Baptist Church,7-12C West Chatham Baptist Church,24,314,308,0,646
Chatham 7-13C Southside Fire Trng Ctr,7-13C Southside Fire Trng Ctr,45,615,396,0,1056
Chatham 7-13C Southside Fire Trng Ctr - Garden City,7-13C Southside Fire Trng Ctr - Garden City,2,0,7,0,9
Chatham 7-14C Coastal Cathedral,7-14C Coastal Cathedral,72,531,623,1,1227
Chatham 7-15C Rice Creek School,7-15C Rice Creek School,10,106,252,0,368
Chatham 7-16C Pooler Recreation Center Gymnasium,7-16C Pooler Recreation Center Gymnasium,85,613,518,0,1216
Chatham 8-01C R.M.G. Civil Rights Museum,8-01C R.M.G. Civil Rights Museum,4,93,77,0,174
Chatham 8-02C Hellenic Center,8-02C Hellenic Center,4,45,58,0,107
Chatham 8-03C Silk Hope Baptist Church,8-03C Silk Hope Baptist Church,10,46,178,0,234
Chatham 8-03C Silk Hope Baptist Church - Garden City,8-03C Silk Hope Baptist Church - Garden City,0,0,1,0,1
Chatham 8-05C W Broad St YMCA,8-05C W Broad St YMCA,0,5,7,0,12
Chatham 8-06C Tompkins Rec Center,8-06C Tompkins Rec Center,0,4,6,0,10
Chatham 8-07C Woodville-Tompkins TI,8-07C Woodville-Tompkins TI,0,7,8,0,15
Chatham 8-08C Resur of Our Lord Church,8-08C Resur of Our Lord Church,1,3,9,0,13
Chatham 8-09C Moses Jackson Center,8-09C Moses Jackson Center,2,1,8,0,11
Chatham 8-10C Carver Heights Comm Ctr,8-10C Carver Heights Comm Ctr,1,2,4,0,7
Chatham 8-11C Butler Elementary,8-11C Butler Elementary,1,2,7,0,10
Chatham 8-12C Beach High School,8-12C Beach High School,2,29,35,0,66
Chatham 8-13C Savannah Christian,8-13C Savannah Christian,18,75,118,0,211
Chatham 8-15C Cooper Center,8-15C Cooper Center,1,15,30,0,46
Chatham 8-16C Mighty 8th Museum,8-16C Mighty 8th Museum,42,306,341,0,689
Chatham 8-17C Georgia Tech Savannah Campus,8-17C Georgia Tech Savannah Campus,9,153,229,1,392
Chatham 8-18C Savannah First 7th Day Adv Church,8-18C Savannah First 7th Day Adv Church,3,43,116,0,162
Chattahoochee Activity Center,Activity Center,17,233,288,0,538
Chattooga Haywood,Haywood,0,7,64,0,71
Chattooga Lyerly,Lyerly,16,295,382,0,693
Chattooga Trion,Trion,43,1048,854,0,1945
Chattooga Summerville,Summerville,74,1135,698,0,1907
Chattooga Dirttown,Dirttown,8,164,283,0,455
Chattooga Subligna,Subligna,8,85,188,0,281
Chattooga Menlo,Menlo,11,235,379,0,625
Cherokee Air Acres,Air Acres,64,477,584,0,1125
Cherokee Arnold Mill,Arnold Mill,93,1208,948,0,2249
Cherokee Avery,Avery,83,1269,731,0,2083
Cherokee Ball Ground,Ball Ground,31,1319,735,0,2085
Cherokee Bascomb,Bascomb,73,934,703,0,1710
Cherokee Bells,Bells,50,945,683,0,1678
Cherokee Booth,Booth,68,970,574,0,1612
Cherokee Bradshaw,Bradshaw,108,1340,742,0,2190
Cherokee Bridgemill,Bridgemill,108,1380,852,0,2340
Cherokee Canton,Canton,205,2128,888,2,3223
Cherokee Carmel,Carmel,65,668,599,3,1335
Cherokee Clayton,Clayton,107,1625,908,1,2641
Cherokee Conns Creek,Conns Creek,11,265,312,0,588
Cherokee Deer Run,Deer Run,32,431,645,0,1108
Cherokee Dixie,Dixie,55,885,718,0,1658
Cherokee Freehome,Freehome,153,1747,1107,0,3007
Cherokee Hickory Flat,Hickory Flat,128,2004,1349,1,3482
Cherokee Hightower,Hightower,69,1166,691,1,1927
Cherokee Hillside,Hillside,68,863,516,0,1447
Cherokee Holly Springs,Holly Springs,46,558,537,0,1141
Cherokee Kellogg,Kellogg,77,890,827,0,1794
Cherokee Liberty,Liberty,124,1500,1119,3,2746
Cherokee Little River,Little River,248,1683,991,1,2923
Cherokee Macedonia,Macedonia,97,1491,1074,1,2663
Cherokee Mountain Road,Mountain Road,70,765,669,0,1504
Cherokee Neese,Neese,136,1351,1014,0,2501
Cherokee Oak Grove,Oak Grove,34,816,539,0,1389
Cherokee R M Moore,R M Moore,77,1067,827,0,1971
Cherokee R T Jones,R T Jones,34,499,260,1,794
Cherokee Rosecreek,Rosecreek,63,930,599,0,1592
Cherokee Salacoa,Salacoa,12,105,293,0,410
Cherokee Sixes,Sixes,95,888,595,0,1578
Cherokee Sutallee,Sutallee,46,576,827,0,1449
Cherokee Teasley,Teasley,132,1908,1310,2,3352
Cherokee Toonigh,Toonigh,120,1467,1065,0,2652
Cherokee Union Hill,Union Hill,82,1179,1162,1,2424
Cherokee Univeter,Univeter,132,1583,857,0,2572
Cherokee Victoria,Victoria,33,610,575,0,1218
Cherokee Waleska,Waleska,85,873,687,0,1645
Cherokee Wildcat,Wildcat,54,608,680,2,1344
Cherokee Woodlands,Woodlands,38,389,734,0,1161
Cherokee Woodstock,Woodstock,100,1525,875,0,2500
Clarke 1A,1A,37,285,249,0,571
Clarke 1B,1B,52,380,198,0,630
Clarke 1C,1C,31,201,187,0,419
Clarke 1D,1D,66,329,270,0,665
Clarke 2A,2A,30,108,157,1,296
Clarke 2B,2B,16,56,91,0,163
Clarke 3A,3A,7,39,41,0,87
Clarke 3B,3B,18,123,95,0,236
Clarke 4A,4A,13,91,70,2,176
Clarke 4B,4B,22,244,209,0,475
Clarke 5A,5A,48,257,202,0,507
Clarke 5B,5B,31,247,204,0,482
Clarke 5C,5C,10,37,69,0,116
Clarke 5D,5D,18,151,163,1,333
Clarke 6A,6A,48,561,326,0,935
Clarke 6B,6B,61,421,265,0,747
Clarke 6C,6C,50,378,334,1,763
Clarke 6D,6D,19,80,116,0,215
Clarke 7A,7A,42,319,258,0,619
Clarke 7B,7B,63,370,175,0,608
Clarke 7C,7C,36,292,228,0,556
Clarke 8A,8A,40,237,157,0,434
Clarke 8B,8B,40,134,146,0,320
Clarke 8C,8C,34,174,249,0,457
Clay Bluffton,Bluffton,6,68,66,1,141
Clay Zetto ,Zetto ,6,36,18,0,60
Clay Court House,Court House,0,30,23,0,53
Clay Old Head Start,Old Head Start,7,74,24,0,105
Clay Days Cross Road,Days Cross Road,6,121,42,0,169
Clayton Ellenwood 1,Ellenwood 1,2,63,19,0,84
Clayton Ellenwood 2,Ellenwood 2,8,63,39,0,110
Clayton Forest Park 1,Forest Park 1,10,104,56,0,170
Clayton Forest Park 2,Forest Park 2,8,70,54,0,132
Clayton Forest Park 3,Forest Park 3,6,92,62,1,161
Clayton Forest Park 4,Forest Park 4,7,128,74,0,209
Clayton Forest Park 5,Forest Park 5,12,102,83,0,197
Clayton Forest Park 6,Forest Park 6,5,102,61,1,169
Clayton Jonesboro 1,Jonesboro 1,11,59,34,1,105
Clayton Jonesboro 2,Jonesboro 2,0,17,14,0,31
Clayton Jonesboro 3,Jonesboro 3,16,110,59,0,185
Clayton Jonesboro 4,Jonesboro 4,6,58,44,0,108
Clayton Jonesboro 5,Jonesboro 5,9,89,88,0,186
Clayton Jonesboro 6,Jonesboro 6,42,455,157,0,654
Clayton Jonesboro 7,Jonesboro 7,10,162,62,0,234
Clayton Jonesboro 8,Jonesboro 8,4,37,43,0,84
Clayton Jonesboro 9,Jonesboro 9,12,44,32,0,88
Clayton Jonesboro 10,Jonesboro 10,8,58,53,0,119
Clayton Jonesboro 11,Jonesboro 11,20,161,75,0,256
Clayton Jonesboro 12,Jonesboro 12,5,42,33,1,81
Clayton Jonesboro 13,Jonesboro 13,6,55,86,0,147
Clayton Jonesboro 14,Jonesboro 14,48,387,131,2,568
Clayton Jonesboro 15,Jonesboro 15,8,53,23,0,84
Clayton Jonesboro 16,Jonesboro 16,13,47,42,0,102
Clayton Jonesboro 17,Jonesboro 17,1,48,32,1,82
Clayton Jonesboro 18,Jonesboro 18,10,84,53,0,147
Clayton Jonesboro 19,Jonesboro 19,7,56,28,0,91
Clayton Jonesboro 20,Jonesboro 20,3,31,23,0,57
Clayton Jonesboro 21,Jonesboro 21,2,56,33,0,91
Clayton Jonesboro 22,Jonesboro 22,1,66,25,0,92
Clayton Lake City,Lake City,1,79,58,0,138
Clayton Lovejoy 1,Lovejoy 1,12,147,65,0,224
Clayton Lovejoy 2,Lovejoy 2,3,90,46,0,139
Clayton Lovejoy 3,Lovejoy 3,13,78,19,0,110
Clayton Lovejoy 4,Lovejoy 4,12,71,38,0,121
Clayton Lovejoy 5,Lovejoy 5,6,68,32,0,106
Clayton Lovejoy 6,Lovejoy 6,6,101,35,0,142
Clayton Lovejoy 7,Lovejoy 7,9,106,58,0,173
Clayton Lovejoy 8,Lovejoy 8,0,21,14,0,35
Clayton Morrow 1,Morrow 1,6,62,46,0,114
Clayton Morrow 2,Morrow 2,3,180,72,0,255
Clayton Morrow 3,Morrow 3,15,125,75,0,215
Clayton Morrow 4,Morrow 4,13,88,60,0,161
Clayton Morrow 5,Morrow 5,3,70,48,0,121
Clayton Morrow 6,Morrow 6,11,113,70,0,194
Clayton Morrow 7,Morrow 7,5,69,54,0,128
Clayton Morrow 8,Morrow 8,9,56,45,0,110
Clayton Morrow 9,Morrow 9,5,48,26,0,79
Clayton Morrow 10,Morrow 10,11,130,40,0,181
Clayton Morrow 11,Morrow 11,1,40,43,1,85
Clayton Oak 1,Oak 1,7,18,14,0,39
Clayton Oak 2,Oak 2,1,15,16,0,32
Clayton Oak 3,Oak 3,0,19,6,0,25
Clayton Oak 4,Oak 4,2,20,20,0,42
Clayton Oak 5,Oak 5,3,24,9,0,36
Clayton Oak 6,Oak 6,2,13,6,0,21
Clayton Panhandle 1,Panhandle 1,7,66,40,0,113
Clayton Panhandle 2,Panhandle 2,17,257,127,0,401
Clayton Riverdale 1,Riverdale 1,4,49,22,0,75
Clayton Riverdale 2,Riverdale 2,4,29,24,0,57
Clayton Riverdale 3,Riverdale 3,11,62,16,2,91
Clayton Riverdale 4,Riverdale 4,22,75,39,0,136
Clayton Riverdale 5,Riverdale 5,11,43,31,0,85
Clayton Riverdale 6,Riverdale 6,6,61,45,0,112
Clayton Riverdale 7,Riverdale 7,9,61,47,0,117
Clayton Riverdale 8,Riverdale 8,16,75,35,0,126
Clayton Riverdale 9,Riverdale 9,8,53,48,0,109
Clayton Riverdale 10,Riverdale 10,2,19,17,0,38
Clayton Riverdale 11,Riverdale 11,2,23,26,0,51
Clayton Riverdale 12,Riverdale 12,12,39,38,0,89
Clinch Arabia,Arabia,0,8,53,0,61
Clinch Argyle,Argyle,0,53,112,0,165
Clinch Dupont,Dupont,4,38,95,0,137
Clinch Fargo,Fargo,0,15,110,0,125
Clinch Homerville,Homerville,29,748,365,0,1142
Cobb Acworth 1A,Acworth 1A,87,945,434,1,1467
Cobb Acworth 1B,Acworth 1B,70,848,476,5,1399
Cobb Acworth 1C,Acworth 1C,28,461,260,2,751
Cobb Addison 01,Addison 01,48,387,273,1,709
Cobb Austell 1A,Austell 1A,11,162,75,0,248
Cobb Austell 1B,Austell 1B,5,88,40,1,134
Cobb Baker 01,Baker 01,39,462,380,2,883
Cobb Bells Ferry 02,Bells Ferry 02,49,341,428,1,819
Cobb Bells Ferry 03,Bells Ferry 03,27,229,287,0,543
Cobb Bells Ferry 04,Bells Ferry 04,47,448,561,0,1056
Cobb Big Shanty 01,Big Shanty 01,51,315,262,0,628
Cobb Big Shanty 02,Big Shanty 02,51,429,420,0,900
Cobb Birney 01,Birney 01,37,196,184,1,418
Cobb Birney 02,Birney 02,55,353,223,0,631
Cobb Bryant 01,Bryant 01,4,27,29,0,60
Cobb Bryant 02,Bryant 02,8,67,51,0,126
Cobb Blackwell 01,Blackwell 01,34,306,317,0,657
Cobb Chattahoochee 01,Chattahoochee 01,24,289,292,1,606
Cobb Cheatham Hill 02,Cheatham Hill 02,70,649,444,1,1164
Cobb Cheatham Hill 03,Cheatham Hill 03,88,756,455,0,1299
Cobb Chalker 01,Chalker 01,87,466,376,1,930
Cobb Clarkdale 01,Clarkdale 01,14,177,130,0,321
Cobb Clarkdale 02,Clarkdale 02,36,370,298,1,705
Cobb Cooper 01,Cooper 01,34,229,149,0,412
Cobb Chestnut Ridge 01,Chestnut Ridge 01,60,651,471,0,1182
Cobb Dickerson 01,Dickerson 01,82,489,430,0,1001
Cobb Dobbins 01,Dobbins 01,14,108,100,0,222
Cobb Dobbins 02,Dobbins 02,15,170,211,0,396
Cobb Dowell 01,Dowell 01,40,464,358,0,862
Cobb Dodgen 01,Dodgen 01,45,329,376,1,751
Cobb Durham 01,Durham 01,71,1268,542,1,1882
Cobb Davis 01,Davis 01,19,277,325,0,621
Cobb Eastside 01,Eastside 01,67,567,435,0,1069
Cobb Eastside 02,Eastside 02,118,779,477,0,1374
Cobb Elizabeth 01,Elizabeth 01,12,210,245,2,469
Cobb Elizabeth 02,Elizabeth 02,76,330,354,1,761
Cobb Elizabeth 03,Elizabeth 03,93,528,399,1,1021
Cobb Elizabeth 04,Elizabeth 04,21,222,296,1,540
Cobb Elizabeth 05,Elizabeth 05,38,446,385,0,869
Cobb East Piedmont 01,East Piedmont 01,31,185,310,1,527
Cobb Fair Oaks 02,Fair Oaks 02,38,352,263,1,654
Cobb Fair Oaks 04,Fair Oaks 04,53,230,199,4,486
Cobb Fullers Park 01,Fullers Park 01,81,539,501,0,1121
Cobb Ford 01,Ford 01,57,847,474,1,1379
Cobb Frey 01,Frey 01,61,759,301,1,1122
Cobb Garrison Mill 01,Garrison Mill 01,47,556,402,1,1006
Cobb Gritters 01,Gritters 01,67,574,584,1,1226
Cobb Harmony-Leland 01,Harmony-Leland 01,12,111,72,0,195
Cobb Harmony-Leland 02,Harmony-Leland 02,23,156,98,1,278
Cobb Harrison 01,Harrison 01,63,836,435,0,1334
Cobb Hightower 01,Hightower 01,125,851,470,3,1449
Cobb Hayes 01,Hayes 01,63,992,466,1,1522
Cobb Kennesaw 1A,Kennesaw 1A,19,285,209,1,514
Cobb Kennesaw 2A,Kennesaw 2A,49,531,358,0,938
Cobb Kennesaw 3A,Kennesaw 3A,71,652,356,4,1083
Cobb Kennesaw 4A,Kennesaw 4A,63,506,336,0,905
Cobb Kennesaw 5A,Kennesaw 5A,51,694,695,0,1440
Cobb Kell 01,Kell 01,33,236,344,2,615
Cobb Kemp 01,Kemp 01,30,503,334,2,869
Cobb Kemp 02,Kemp 02,112,824,473,1,1410
Cobb Kemp 03,Kemp 03,81,1131,617,0,1829
Cobb Lassiter 01,Lassiter 01,62,720,469,1,1252
Cobb Lindley 01,Lindley 01,35,310,233,0,578
Cobb Lost Mountain 01,Lost Mountain 01,69,959,290,0,1318
Cobb Lost Mountain 02,Lost Mountain 02,92,1178,585,1,1856
Cobb Lost Mountain 03,Lost Mountain 03,95,1524,472,0,2091
Cobb Lost Mountain 04,Lost Mountain 04,48,691,347,0,1086
Cobb Mableton 01,Mableton 01,78,472,165,3,718
Cobb Mableton 02,Mableton 02,24,191,143,2,360
Cobb Mableton 03,Mableton 03,50,371,247,0,668
Cobb Mableton 04,Mableton 04,31,222,152,0,405
Cobb Mabry 01,Mabry 01,36,329,299,0,664
Cobb Macland 01,Macland 01,21,330,206,0,557
Cobb Murdock 01,Murdock 01,86,722,554,1,1363
Cobb McEachern 01,McEachern 01,62,473,247,1,783
Cobb McCleskey 01,McCleskey 01,24,320,302,0,646
Cobb McClure 01,McClure 01,58,733,467,0,1258
Cobb Marietta 1A,Marietta 1A,34,301,195,1,531
Cobb Marietta 2A,Marietta 2A,51,328,371,1,751
Cobb Marietta 2B,Marietta 2B,50,527,370,0,947
Cobb Marietta 3A,Marietta 3A,87,616,478,0,1181
Cobb Marietta 3B,Marietta 3B,12,70,77,0,159
Cobb Marietta 4A,Marietta 4A,52,484,459,1,996
Cobb Marietta 4B,Marietta 4B,32,238,236,1,507
Cobb Marietta 4C,Marietta 4C,54,679,445,0,1178
Cobb Marietta 5A,Marietta 5A,36,266,188,1,491
Cobb Marietta 5B,Marietta 5B,6,95,108,0,209
Cobb Marietta 6A,Marietta 6A,17,105,83,1,206
Cobb Marietta 6B,Marietta 6B,43,349,383,0,775
Cobb Marietta 7A,Marietta 7A,11,89,99,0,199
Cobb Mars Hill 01,Mars Hill 01,56,939,603,0,1598
Cobb Mars Hill 02,Mars Hill 02,26,433,384,2,845
Cobb Mt. Bethel 01,Mt. Bethel 01,91,804,554,1,1450
Cobb Mt. Bethel 03,Mt. Bethel 03,77,674,313,3,1067
Cobb Mt. Bethel 04,Mt. Bethel 04,67,639,368,0,1074
Cobb North Cobb 01,North Cobb 01,32,312,244,1,589
Cobb Nickajack 01,Nickajack 01,24,247,201,0,472
Cobb Norton Park 01,Norton Park 01,56,415,337,2,810
Cobb Nicholson 01,Nicholson 01,41,329,317,0,687
Cobb Oakdale 01,Oakdale 01,74,441,314,0,829
Cobb Oregon 01,Oregon 01,32,378,217,0,627
Cobb Oregon 02,Oregon 02,74,364,246,0,684
Cobb Oregon 03,Oregon 03,40,305,207,1,553
Cobb Oregon 04,Oregon 04,53,383,179,0,615
Cobb Oregon 05,Oregon 05,38,493,358,1,890
Cobb Pebblebrook 01,Pebblebrook 01,30,201,148,0,379
Cobb Powers Ferry 01,Powers Ferry 01,61,401,388,0,850
Cobb Pine Mountain 01,Pine Mountain 01,62,883,514,0,1459
Cobb Pine Mountain 02,Pine Mountain 02,73,892,525,1,1491
Cobb Post Oak 01,Post Oak 01,67,721,544,0,1332
Cobb Pope 01,Pope 01,75,638,313,0,1026
Cobb Palmer 01,Palmer 01,78,376,366,1,821
Cobb Powder Springs 1A,Powder Springs 1A,44,436,221,0,701
Cobb Powder Springs 2A,Powder Springs 2A,23,170,85,0,278
Cobb Powder Springs 3A,Powder Springs 3A,31,291,154,0,476
Cobb Pitner 01,Pitner 01,37,292,466,1,796
Cobb Rocky Mount 01,Rocky Mount 01,46,515,566,0,1127
Cobb Riverside 01,Riverside 01,4,28,28,0,60
Cobb Roswell 01,Roswell 01,133,988,762,0,1883
Cobb Roswell 02,Roswell 02,92,687,497,1,1277
Cobb Sandy Plains 01,Sandy Plains 01,51,438,341,1,831
Cobb Shallowford Falls 01,Shallowford Falls 01,71,582,530,0,1183
Cobb Simpson 01,Simpson 01,34,325,215,0,574
Cobb Sewell Mill 01,Sewell Mill 01,75,556,414,0,1045
Cobb Sewell Mill 03,Sewell Mill 03,93,420,386,2,901
Cobb Smyrna 1A,Smyrna 1A,28,181,166,0,375
Cobb Smyrna 2A,Smyrna 2A,36,313,198,1,548
Cobb Smyrna 3A,Smyrna 3A,34,429,252,0,715
Cobb Smyrna 3B,Smyrna 3B,27,291,202,1,521
Cobb Smyrna 4A,Smyrna 4A,134,807,465,0,1406
Cobb Smyrna 5A,Smyrna 5A,44,297,244,1,586
Cobb Smyrna 6A,Smyrna 6A,120,771,415,2,1308
Cobb Smyrna 7A,Smyrna 7A,93,589,314,1,997
Cobb Sope Creek 01,Sope Creek 01,73,373,333,0,779
Cobb Sope Creek 02,Sope Creek 02,91,694,553,0,1338
Cobb Sope Creek 03,Sope Creek 03,41,473,496,1,1011
Cobb Sweetwater 01,Sweetwater 01,51,356,238,0,645
Cobb Sweetwater 02,Sweetwater 02,29,147,110,0,286
Cobb Terrell Mill 01,Terrell Mill 01,38,350,324,0,712
Cobb Timber Ridge 01,Timber Ridge 01,55,399,388,0,842
Cobb Vaughan 01,Vaughan 01,44,793,453,0,1290
Cobb Vinings 01,Vinings 01,41,252,245,1,539
Cobb Vinings 02,Vinings 02,96,633,327,1,1057
Cobb Vinings 03,Vinings 03,67,486,253,3,809
Cobb Vinings 04,Vinings 04,107,489,525,1,1122
Cobb Wade Green 02,Wade Green 02,58,547,498,1,1104
Cobb Willeo 01,Willeo 01,64,568,372,0,1004
Coffee Douglas,Douglas,121,3452,1464,4,5041
Coffee Ambrose,Ambrose,14,425,474,0,913
Coffee Bridgetown,Bridgetown,2,52,100,0,154
Coffee Broxton,Broxton,8,495,507,0,1010
Coffee Nicholls,Nicholls,12,361,427,1,801
Coffee West Green,West Green,5,186,337,0,528
Colquitt Shaw ,Shaw ,8,209,73,0,290
Colquitt Moultrie,Moultrie,73,870,453,0,1396
Colquitt Autreyville,Autreyville,10,278,318,0,606
Colquitt Bridgecreek,Bridgecreek,14,315,312,0,641
Colquitt Crosland,Crosland,1,16,96,0,113
Colquitt Doerun,Doerun,6,67,175,0,248
Colquitt Funston,Funston,10,199,310,0,519
Colquitt Hamilton,Hamilton,8,123,270,0,401
Colquitt Hartsfield,Hartsfield,8,73,179,0,260
Colquitt Hopewell,Hopewell,15,413,346,1,775
Colquitt Lee,Lee,13,184,241,0,438
Colquitt Millcreek,Millcreek,3,82,134,0,219
Colquitt Monk,Monk,29,324,361,0,714
Colquitt Murphy,Murphy,11,318,260,0,589
Colquitt Norman Park,Norman Park,20,463,433,0,916
Colquitt Robinson,Robinson,7,123,252,0,382
Colquitt Thigpen,Thigpen,2,35,88,0,125
Colquitt TyTy,TyTy,4,44,225,0,273
Colquitt Warrior,Warrior,14,150,321,0,485
Columbia Kiokee Bapt Church,Kiokee Bapt Church,38,892,795,2,1727
Columbia Stevens Creek Church-Grovetown,Stevens Creek Church-Grovetown,11,270,240,0,521
Columbia Lewis Methodist,Lewis Methodist,39,799,621,0,1459
Columbia Woodlawn Bapt Church,Woodlawn Bapt Church,15,328,256,0,599
Columbia Patriots Park,Patriots Park,14,477,295,0,786
Columbia New Life Church,New Life Church,4,111,136,0,251
Columbia Columbia Co. Health Dept.,Columbia Co. Health Dept.,22,403,423,0,848
Columbia Harlem Branch Library,Harlem Branch Library,28,577,514,0,1119
Columbia Harlem Senior Center,Harlem Senior Center,12,247,389,0,648
Columbia Second Mount Moriah Baptist Church,Second Mount Moriah Baptist Church,9,269,331,0,609
Columbia Bessie Thomas Center,Bessie Thomas Center,6,234,197,0,437
Columbia Philadelphia Church,Philadelphia Church,15,334,314,0,663
Columbia Liberty Park-Grovetown,Liberty Park-Grovetown,16,331,383,1,731
Columbia Grovetown Methodist,Grovetown Methodist,10,172,188,0,370
Columbia G A Apostolic Church,G A Apostolic Church,21,261,329,0,611
Columbia Grovetown Dept of Public Safety Station #2,Grovetown Dept of Public Safety Station #2,17,389,298,0,704
Columbia Grove First Baptist Church,Grove First Baptist Church,13,295,238,0,546
Columbia Eubank/Blanchard Ctr,Eubank/Blanchard Ctr,10,289,381,0,680
Columbia Second Mt. Carmel Baptist Church,Second Mt. Carmel Baptist Church,8,104,134,1,247
Columbia Damascus Bapt Church,Damascus Bapt Church,7,243,436,1,687
Columbia Col Cty Board of Edu,Col Cty Board of Edu,30,521,292,0,843
Columbia Greenbrier High,Greenbrier High,39,827,712,0,1578
Columbia Parkway Baptist Church,Parkway Baptist Church,44,538,474,0,1056
Columbia Riverview Church,Riverview Church,18,316,245,0,579
Columbia Grace Baptist Church,Grace Baptist Church,23,616,603,0,1242
Columbia Christ Sanctified,Christ Sanctified,34,482,455,0,971
Columbia Parkway Elementary,Parkway Elementary,17,543,464,0,1024
Columbia Blanchard Park,Blanchard Park,23,261,285,0,569
Columbia Belair Baptist Church,Belair Baptist Church,28,375,499,0,902
Columbia Marvin Methodist,Marvin Methodist,17,235,415,0,667
Columbia Westside Bapt Church,Westside Bapt Church,28,311,343,0,682
Columbia Trinity Bapt Church,Trinity Bapt Church,41,499,565,3,1108
Columbia Abilene Baptist,Abilene Baptist,32,313,353,0,698
Columbia Augusta Christian,Augusta Christian,38,343,390,0,771
Columbia Savannah Rapids Pavilion,Savannah Rapids Pavilion,51,511,288,0,850
Columbia Gospel Water Branch,Gospel Water Branch,14,518,403,1,936
Columbia ACS-Furys Ferry Rd Campus,ACS-Furys Ferry Rd Campus,43,391,402,0,836
Columbia Stevens Creek Church,Stevens Creek Church,40,675,641,1,1357
Columbia Columbia Co. Fire HDQTR,Columbia Co. Fire HDQTR,7,136,214,1,358
Columbia Lakeside Middle,Lakeside Middle,16,286,275,0,577
Columbia Martinez Baptist,Martinez Baptist,20,167,351,0,538
Columbia Gold Cross EMS,Gold Cross EMS,119,355,327,1,802
Columbia Church of Our Savior,Church of Our Savior,33,284,386,0,703
Columbia West Acres Baptist,West Acres Baptist,42,501,418,0,961
Columbia Journey Comm Church,Journey Comm Church,36,451,253,0,740
Columbia Wesley Methodist,Wesley Methodist,24,609,434,0,1067
Columbia Col Cty Main Library,Col Cty Main Library,20,525,279,1,825
Columbia Christ Church Presbyterian,Christ Church Presbyterian,20,512,409,0,941
Columbia Blueridge Elementary,Blueridge Elementary,31,434,346,0,811
Columbia Christ The King Church,Christ The King Church,54,528,355,0,937
Cook Cecil,Cecil,11,318,213,0,542
Cook Delle Beamguard,Delle Beamguard,37,621,341,0,999
Cook Elm Pine,Elm Pine,2,5,8,0,15
Cook Lenox,Lenox,13,217,345,0,575
Cook Massee,Massee,8,280,147,0,435
Cook New Life Baptist Church,New Life Baptist Church,16,304,292,0,612
Cook Riverbend,Riverbend,33,381,207,0,621
Cook Sparks,Sparks,4,68,73,0,145
Coweta Senoia,Senoia,93,1489,1408,0,2990
Coweta Moreland,Moreland,56,557,899,1,1513
Coweta Pine Road,Pine Road,43,434,695,0,1172
Coweta Dresden,Dresden,1,78,353,0,432
Coweta Newnan,Newnan,31,292,302,0,625
Coweta Sharpsburg,Sharpsburg,54,1343,894,0,2291
Coweta Fischer Road,Fischer Road,75,1108,781,0,1964
Coweta Grantville,Grantville,17,221,650,0,888
Coweta Haralson,Haralson,21,394,804,0,1219
Coweta Welcome,Welcome,46,426,983,1,1456
Coweta Panther Creek,Panther Creek,40,389,769,1,1199
Coweta Raymond,Raymond,55,576,672,0,1303
Coweta Turin,Turin,61,1327,1170,1,2559
Coweta Smokey Road,Smokey Road,26,266,367,0,659
Coweta Central,Central,29,337,231,0,597
Coweta Newnan Centre,Newnan Centre,299,3973,1999,0,6271
Coweta Greentop,Greentop,59,383,513,0,955
Coweta Expo Center,Expo Center,38,380,434,0,852
Coweta White Oak,White Oak,50,1141,645,0,1836
Coweta Madras,Madras,211,2571,1810,2,4594
Coweta Cannongate,Cannongate,41,871,843,1,1756
Coweta Westside,Westside,9,49,66,0,124
Coweta Northside,Northside,47,366,517,0,930
Coweta Thomas Crossroads,Thomas Crossroads,67,1373,887,1,2328
Coweta Coweta Central Library,Coweta Central Library,22,714,263,0,999
Crawford District 1,District 1,21,261,121,1,404
Crawford District 2,District 2,22,369,288,0,679
Crawford District 3,District 3,21,395,304,0,720
Crawford District 4,District 4,34,382,491,1,908
Crawford District 5,District 5,18,270,441,0,729
Crisp Arabi,Arabi,15,146,187,0,348
Crisp Coney,Coney,20,301,252,0,573
Crisp Cordele,Cordele,124,1334,459,1,1918
Crisp Jamestown,Jamestown,22,422,313,0,757
Crisp Listonia,Listonia,14,241,207,0,462
Dade South Dade,South Dade,8,160,250,0,418
Dade New Salem,New Salem,19,237,384,1,641
Dade Davis,Davis,13,364,581,1,959
Dade New Home,New Home,5,100,218,0,323
Dade West Brow,West Brow,19,187,316,0,522
Dade Trenton,Trenton,18,655,447,1,1121
Dade North Dade,North Dade,11,329,374,0,714
Dawson West,West,64,842,549,0,1455
Dawson Central,Central,149,3479,1429,0,5057
Dawson East,East,155,2912,1605,1,4673
Decatur Mt. Pleasant,Mt. Pleasant,8,138,184,0,330
Decatur Recovery,Recovery,18,121,214,1,354
Decatur Kendrick,Kendrick,6,111,143,2,262
Decatur Climax,Climax,12,204,255,0,471
Decatur Brinson,Brinson,14,162,253,1,430
Decatur West Bainbridge,West Bainbridge,29,383,189,0,601
Decatur Bainbridge-Coliseum,Bainbridge-Coliseum,35,277,163,0,475
Decatur Bainbridge-Fairgrounds,Bainbridge-Fairgrounds,21,415,328,0,764
Decatur Attapulgus,Attapulgus,12,178,174,1,365
Decatur Kirbo Center,Kirbo Center,57,963,361,0,1381
DeKalb Allgood Elem,Allgood Elem,9,67,61,0,137
DeKalb Ashford Park Elem,Ashford Park Elem,11,328,372,0,711
DeKalb Austin,Austin,31,543,321,0,895
DeKalb Avondale,Avondale,30,187,239,0,456
DeKalb Austin Drive,Austin Drive,3,21,19,0,43
DeKalb Ashford Dunwoody Rd,Ashford Dunwoody Rd,34,395,372,0,801
DeKalb Ashford Parkside,Ashford Parkside,32,411,330,0,773
DeKalb Avondale High,Avondale High,14,103,74,1,192
DeKalb Boulevard,Boulevard,5,109,62,0,176
DeKalb Briar Vista Elem,Briar Vista Elem,27,127,150,0,304
DeKalb Briarlake Elem,Briarlake Elem,30,174,183,0,387
DeKalb Briarwood,Briarwood,12,287,139,0,438
DeKalb Brockett Elem,Brockett Elem,22,276,112,0,410
DeKalb Briarcliff,Briarcliff,59,208,262,0,529
DeKalb Brockett,Brockett,19,178,202,0,399
DeKalb Brookhaven,Brookhaven,28,381,376,0,785
DeKalb Browns Mill Elem,Browns Mill Elem,11,30,20,0,61
DeKalb Bouldercrest Road,Bouldercrest Road,3,26,14,0,43
DeKalb Bethune Middle,Bethune Middle,4,39,25,0,68
DeKalb Burgess Elem,Burgess Elem,3,49,49,0,101
DeKalb Columbia Drive,Columbia Drive,2,20,17,0,39
DeKalb Canby Lane Elem,Canby Lane Elem,5,22,12,0,39
DeKalb Columbia Elem,Columbia Elem,0,3,8,0,11
DeKalb Cedar Grove Elem,Cedar Grove Elem,3,26,25,0,54
DeKalb Chamblee,Chamblee,5,243,129,0,377
DeKalb Candler-Murphey Candler Elem,Candler-Murphey Candler Elem,8,74,50,0,132
DeKalb Chapel Hill Elem,Chapel Hill Elem,5,18,30,0,53
DeKalb Chesnut Elem,Chesnut Elem,11,140,127,0,278
DeKalb Clairemont West,Clairemont West,39,117,113,0,269
DeKalb Clairmont Road,Clairmont Road,37,123,115,0,275
DeKalb Clarkston,Clarkston,2,65,61,1,129
DeKalb Clifton,Clifton,4,18,5,0,27
DeKalb Columbia Middle,Columbia Middle,0,7,19,0,26
DeKalb Coan Recreation Center,Coan Recreation Center,7,79,58,0,144
DeKalb Cross Keys High,Cross Keys High,13,172,126,0,311
DeKalb Crossroads,Crossroads,6,33,24,0,63
DeKalb Candler,Candler,2,42,32,1,77
DeKalb Cedar Grove Middle,Cedar Grove Middle,2,12,11,0,25
DeKalb Cedar Grove South,Cedar Grove South,4,38,25,0,67
DeKalb Covington Hwy,Covington Hwy,0,2,3,0,5
DeKalb Covington,Covington,3,37,39,2,81
DeKalb Clairemont East,Clairemont East,23,144,96,0,263
DeKalb Coralwood,Coralwood,46,306,197,1,550
DeKalb Candler Park,Candler Park,15,123,104,0,242
DeKalb Clarkston Community Center,Clarkston Community Center,0,56,75,0,131
DeKalb Chamblee 2,Chamblee 2,21,394,220,0,635
DeKalb Doraville North,Doraville North,19,113,170,0,302
DeKalb Doraville South,Doraville South,6,58,104,0,168
DeKalb Dresden Elem,Dresden Elem,24,297,260,0,581
DeKalb Decatur,Decatur,4,49,40,0,93
DeKalb Dunaire Elem,Dunaire Elem,7,63,56,2,128
DeKalb Dunwoody,Dunwoody,18,352,180,0,550
DeKalb Dunwoody 2,Dunwoody 2,29,407,208,0,644
DeKalb Druid Hills High,Druid Hills High,19,103,96,0,218
DeKalb Dunwoody Library,Dunwoody Library,37,635,234,0,906
DeKalb East Lake,East Lake,7,111,81,0,199
DeKalb Embry Hills,Embry Hills,23,191,83,0,297
DeKalb Evansdale Elem,Evansdale Elem,34,305,222,1,562
DeKalb Emory South,Emory South,14,160,148,1,323
DeKalb Emory Road,Emory Road,10,49,39,0,98
DeKalb Fairington Elem,Fairington Elem,4,23,28,0,55
DeKalb Fernbank Elem,Fernbank Elem,14,152,129,0,295
DeKalb Flat Shoals Elem,Flat Shoals Elem,4,15,13,0,32
DeKalb Flat Shoals Parkway,Flat Shoals Parkway,4,32,24,0,60
DeKalb Flat Rock Elem,Flat Rock Elem,3,21,26,0,50
DeKalb Flat Shoals,Flat Shoals,2,16,12,0,30
DeKalb Flakes Mill,Flakes Mill,2,20,7,0,29
DeKalb Flat Shoals Library,Flat Shoals Library,0,24,11,0,35
DeKalb Freedom Middle,Freedom Middle,8,67,49,0,124
DeKalb Glennwood,Glennwood,19,68,54,0,141
DeKalb Glenhaven,Glenhaven,4,32,38,0,74
DeKalb Gresham Road,Gresham Road,1,45,24,1,71
DeKalb Georgetown Sq,Georgetown Sq,23,359,199,0,581
DeKalb Glenwood Road,Glenwood Road,10,17,33,0,60
DeKalb Hambrick Elem,Hambrick Elem,13,101,116,1,231
DeKalb Hawthorne Elem,Hawthorne Elem,25,206,214,0,445
DeKalb Henderson Mill,Henderson Mill,43,285,174,0,502
DeKalb Huntley Hills Elem,Huntley Hills Elem,23,215,191,1,430
DeKalb Hugh Howell,Hugh Howell,17,228,173,0,418
DeKalb Harris-Narvie J Harris Elem,Harris-Narvie J Harris Elem,1,35,23,0,59
DeKalb Harris-Margaret Harris ED,Harris-Margaret Harris ED,4,48,62,0,114
DeKalb Idlewood Elem,Idlewood Elem,13,93,121,0,227
DeKalb Indian Creek,Indian Creek,4,51,47,1,103
DeKalb Johnson Estates,Johnson Estates,17,107,85,0,209
DeKalb Jolly Elem,Jolly Elem,21,121,140,1,283
DeKalb Kelley Lake Elem,Kelley Lake Elem,4,23,21,0,48
DeKalb Kingsley Elem,Kingsley Elem,61,509,301,0,871
DeKalb Kelley Chapel Road,Kelley Chapel Road,3,8,17,0,28
DeKalb Knollwood,Knollwood,0,25,35,0,60
DeKalb Kittredge Elem,Kittredge Elem,29,399,200,0,628
DeKalb Lakeside High,Lakeside High,52,281,287,0,620
DeKalb Lavista Road,Lavista Road,43,139,171,0,353
DeKalb Lavista,Lavista,23,154,168,1,346
DeKalb Lithonia,Lithonia,0,20,20,0,40
DeKalb Lin-Mary Lin Elem,Lin-Mary Lin Elem,18,123,94,0,235
DeKalb Lithonia High,Lithonia High,0,19,23,0,42
DeKalb Livsey Elem,Livsey Elem,12,179,112,0,303
DeKalb Miller-Eldridge L Miller Elem,Miller-Eldridge L Miller Elem,4,36,34,0,74
DeKalb McNair High,McNair High,8,39,53,0,100
DeKalb Marbut Elem,Marbut Elem,4,18,20,0,42
DeKalb McNair,McNair,4,21,26,0,51
DeKalb McLendon,McLendon,18,129,121,0,268
DeKalb McWilliams,McWilliams,2,25,9,0,36
DeKalb Medlock,Medlock,20,115,104,0,239
DeKalb Midvale Elem,Midvale Elem,47,411,258,0,716
DeKalb Miller Grove,Miller Grove,3,20,13,0,36
DeKalb Montclair Elem,Montclair Elem,2,43,49,0,94
DeKalb Montreal,Montreal,11,108,129,0,248
DeKalb Meadowview,Meadowview,3,20,20,0,43
DeKalb Memorial South,Memorial South,2,50,46,0,98
DeKalb Midway,Midway,7,48,21,0,76
DeKalb McNair Academy,McNair Academy,2,9,15,0,26
DeKalb Mount Vernon East,Mount Vernon East,36,522,339,0,897
DeKalb Mathis-Bob Mathis Elem,Mathis-Bob Mathis Elem,9,38,9,0,56
DeKalb Mount Vernon West,Mount Vernon West,22,420,192,0,634
DeKalb Metropolitan,Metropolitan,3,54,53,0,110
DeKalb Montgomery Elem,Montgomery Elem,40,321,259,0,620
DeKalb Miller Grove Road,Miller Grove Road,1,26,21,0,48
DeKalb Midvale Road,Midvale Road,9,83,55,0,147
DeKalb Miller Grove High,Miller Grove High,0,21,21,0,42
DeKalb North Decatur,North Decatur,17,42,41,0,100
DeKalb North Hairston,North Hairston,5,58,48,0,111
DeKalb Northlake,Northlake,11,104,121,0,236
DeKalb North Peachtree,North Peachtree,13,119,119,0,251
DeKalb Oak Grove Elem,Oak Grove Elem,21,182,213,0,416
DeKalb Oakcliff Elem,Oakcliff Elem,19,78,139,1,237
DeKalb Oakhurst,Oakhurst,3,42,71,0,116
DeKalb Oak View Elem,Oak View Elem,6,21,14,0,41
DeKalb Peachcrest,Peachcrest,3,41,34,0,78
DeKalb Peachtree Middle,Peachtree Middle,29,261,129,0,419
DeKalb Princeton Elem,Princeton Elem,3,30,22,0,55
DeKalb Pine Lake,Pine Lake,1,5,31,0,37
DeKalb Pleasantdale Road,Pleasantdale Road,15,133,95,0,243
DeKalb Ponce de Leon,Ponce de Leon,22,68,97,0,187
DeKalb Panola,Panola,3,18,15,0,36
DeKalb Panola Way Elem,Panola Way Elem,3,13,13,0,29
DeKalb Piney Grove,Piney Grove,2,17,20,0,39
DeKalb Panola Road,Panola Road,2,16,15,0,33
DeKalb Rainbow Elem,Rainbow Elem,4,44,20,0,68
DeKalb Redan Elem,Redan Elem,4,25,17,0,46
DeKalb Rehoboth,Rehoboth,17,165,125,0,307
DeKalb Rockbridge Elem,Rockbridge Elem,9,45,47,0,101
DeKalb Rock Chapel Elem,Rock Chapel Elem,4,34,22,0,60
DeKalb Rowland Elem,Rowland Elem,2,36,45,0,83
DeKalb Redan-Trotti Library,Redan-Trotti Library,3,33,15,0,51
DeKalb Rockbridge Road,Rockbridge Road,6,42,44,0,92
DeKalb Rowland Road,Rowland Road,10,23,42,0,75
DeKalb Redan Road,Redan Road,1,28,23,0,52
DeKalb Rock Chapel Road,Rock Chapel Road,22,73,59,0,154
DeKalb Redan Middle,Redan Middle,6,28,23,0,57
DeKalb Sagamore Hills Elem,Sagamore Hills Elem,47,315,219,0,581
DeKalb Scott,Scott,20,112,98,0,230
DeKalb Shaw-Robert Shaw Elem,Shaw-Robert Shaw Elem,7,51,64,1,123
DeKalb Stone Mountain Elem,Stone Mountain Elem,115,129,64,0,308
DeKalb Silver Lake,Silver Lake,44,700,386,0,1130
DeKalb Skyland,Skyland,11,309,236,1,557
DeKalb Snapfinger Elem,Snapfinger Elem,6,17,22,0,45
DeKalb Smoke Rise,Smoke Rise,45,276,186,1,508
DeKalb Stone Mtn Middle,Stone Mtn Middle,8,36,47,0,91
DeKalb Stone Mill Elem,Stone Mill Elem,6,36,27,0,69
DeKalb Shadow Rock Elem,Shadow Rock Elem,14,54,28,0,96
DeKalb Stoneview Elem,Stoneview Elem,2,14,15,0,31
DeKalb Salem Middle,Salem Middle,2,24,35,0,61
DeKalb Shamrock,Shamrock,16,115,77,0,208
DeKalb South Deshon,South Deshon,3,25,22,0,50
DeKalb Stone Mtn Champion,Stone Mtn Champion,4,46,57,0,107
DeKalb Stone Mtn,Stone Mtn,3,70,55,0,128
DeKalb Snapfinger Road N,Snapfinger Road N,12,22,18,0,52
DeKalb Snapfinger Road S,Snapfinger Road S,4,14,23,0,41
DeKalb Stephenson Middle,Stephenson Middle,6,48,51,0,105
DeKalb South Hairston,South Hairston,2,30,31,0,63
DeKalb Stephenson High,Stephenson High,7,61,41,0,109
DeKalb Stonecrest Library,Stonecrest Library,2,31,23,0,56
DeKalb Snapfinger Road,Snapfinger Road,7,51,24,0,82
DeKalb Terry Mill,Terry Mill,5,28,31,0,64
DeKalb Toney Elem,Toney Elem,2,14,19,0,35
DeKalb Tucker Library,Tucker Library,49,471,192,0,712
DeKalb Tilly Mill Road,Tilly Mill Road,17,232,194,0,443
DeKalb Tucker,Tucker,27,322,139,0,488
DeKalb Valley Brook,Valley Brook,8,38,48,0,94
DeKalb Wadsworth,Wadsworth,6,23,9,0,38
DeKalb Wesley Chapel Library,Wesley Chapel Library,3,30,13,0,46
DeKalb Woodrow Road,Woodrow Road,12,36,26,0,74
DeKalb Winnona Park,Winnona Park,14,46,68,0,128
DeKalb Woodridge Elem,Woodridge Elem,7,48,30,0,85
DeKalb Warren Tech,Warren Tech,8,54,111,0,173
DeKalb Woodward,Woodward,32,201,114,0,347
DeKalb White Oak,White Oak,0,16,14,0,30
DeKalb Winters Chapel,Winters Chapel,19,201,177,2,399
DeKalb Wynbrooke Elem,Wynbrooke Elem,6,63,35,0,104
DeKalb Young Road,Young Road,0,27,9,0,36
Dodge Chauncey,Chauncey,7,55,140,0,202
Dodge Clark,Clark,3,13,42,0,58
Dodge Eddin,Eddin,15,203,224,0,442
Dodge Empire,Empire,7,89,135,0,231
Dodge Jaybird,Jaybird,6,17,59,0,82
Dodge Jones,Jones,6,84,141,0,231
Dodge Lee,Lee,86,1019,469,1,1575
Dodge McCranie,McCranie,7,53,120,0,180
Dodge Milan,Milan,4,42,120,0,166
Dodge Mitchell,Mitchell,3,55,131,0,189
Dodge Mullis,Mullis,4,53,194,0,251
Dodge Plainfield,Plainfield,5,99,161,0,265
Dodge Pondtown,Pondtown,21,112,228,0,361
Dodge Rawlins,Rawlins,15,201,169,0,385
Dodge Vilula,Vilula,2,29,100,0,131
Dodge Yonker,Yonker,1,19,126,0,146
Dooly Lilly,Lilly,2,57,87,0,146
Dooly Byromville,Byromville,6,54,128,0,188
Dooly Unadilla,Unadilla,17,210,233,0,460
Dooly Vienna,Vienna,22,525,203,0,750
Dooly Pinehurst,Pinehurst,8,101,131,0,240
Dougherty Sherwood Elementary School,Sherwood Elementary School,18,130,326,0,474
Dougherty Covenant Church,Covenant Church,12,137,302,0,451
Dougherty Greenbriar Church,Greenbriar Church,53,561,554,0,1168
Dougherty Westover High School,Westover High School,70,602,551,0,1223
Dougherty Merry Acres Middle,Merry Acres Middle,21,210,373,0,604
Dougherty ASU West Campus,ASU West Campus,19,163,191,0,373
Dougherty Westown Elementary School,Westown Elementary School,2,26,27,0,55
Dougherty 2nd Mt. Zion Church,2nd Mt. Zion Church,19,91,301,0,411
Dougherty Mt. Zion Center ,Mt. Zion Center ,0,5,15,0,20
Dougherty Alice Coachman Elementary,Alice Coachman Elementary,0,2,9,0,11
Dougherty Driskell Community Center,Driskell Community Center,0,4,4,0,8
Dougherty Shiloh Baptist Church,Shiloh Baptist Church,3,2,7,0,12
Dougherty Litman Cathedral,Litman Cathedral,2,3,5,0,10
Dougherty Phoebe Healthworks,Phoebe Healthworks,26,276,369,2,673
Dougherty Turner Elementary School,Turner Elementary School,1,1,8,0,10
Dougherty Robert H. Harvey Elementary,Robert H. Harvey Elementary,0,5,8,0,13
Dougherty Bill Miller Community Center,Bill Miller Community Center,0,23,42,0,65
Dougherty Radium Middle School,Radium Middle School,8,22,57,0,87
Dougherty Putney 1st Baptist Church,Putney 1st Baptist Church,14,121,482,0,617
Dougherty International Studies,International Studies,9,43,114,1,167
Dougherty Phoebe East ,Phoebe East ,5,29,73,0,107
Dougherty Pine Bluff Baptist Church,Pine Bluff Baptist Church,12,81,216,0,309
Dougherty Albany Middle School,Albany Middle School,5,9,30,0,44
Dougherty Christ Church,Christ Church,25,232,548,0,805
Dougherty Lamar Reese Elementary School,Lamar Reese Elementary School,4,5,23,0,32
Dougherty ASU East Campus - Lovett Hall ,ASU East Campus - Lovett Hall ,0,0,6,0,6
Douglas Mirror Lake Elementary,Mirror Lake Elementary,55,751,574,0,1380
Douglas Winston,Winston,16,212,155,0,383
Douglas Dog River Library,Dog River Library,67,1599,542,0,2208
Douglas Atlanta West Pentecostal,Atlanta West Pentecostal,6,62,67,0,135
Douglas Ephesus Baptist Church,Ephesus Baptist Church,45,1045,720,0,1810
Douglas Prays Mill Gym,Prays Mill Gym,57,1050,479,0,1586
Douglas Turner,Turner,54,404,240,1,699
Douglas First Baptist Lithia Springs,First Baptist Lithia Springs,17,237,144,0,398
Douglas Lithia Springs High School,Lithia Springs High School,22,292,107,0,421
Douglas Deer Lick,Deer Lick,15,338,132,0,485
Douglas Golden Methodist Church,Golden Methodist Church,14,151,93,0,258
Douglas Old Courthouse,Old Courthouse,41,483,147,0,671
Douglas Beulah Baptist Church,Beulah Baptist Church,38,460,288,0,786
Douglas Stewart,Stewart,4,129,44,0,177
Douglas Arbor Station,Arbor Station,16,197,160,0,373
Douglas Bright Star,Bright Star,18,353,324,0,695
Douglas Dorsett Shoals,Dorsett Shoals,37,528,290,0,855
Douglas Chapel Hill,Chapel Hill,9,317,160,0,486
Douglas Church At Chapel Hill,Church At Chapel Hill,27,579,253,0,859
Douglas Chestnut Log,Chestnut Log,20,295,130,0,445
Douglas St Julians Episcopal,St Julians Episcopal,19,251,205,0,475
Douglas Lutheran Church-GS,Lutheran Church-GS,24,432,244,1,701
Douglas First Baptist Douglasville,First Baptist Douglasville,31,319,151,0,501
Douglas Factory Shoals,Factory Shoals,20,345,171,0,536
Douglas Boundary Waters,Boundary Waters,11,187,68,0,266
Early Arlington ,Arlington ,13,96,136,0,245
Early Blakely,Blakely,26,458,149,3,636
Early Cedar Springs ,Cedar Springs ,9,197,300,1,507
Early Cuba,Cuba,12,230,224,0,466
Early Urquhart,Urquhart,17,204,134,0,355
Echols Statenville,Statenville,31,571,334,1,937
Effingham 1A,1A,24,503,645,2,1174
Effingham 1B,1B,18,559,591,1,1169
Effingham 1C,1C,6,226,566,2,800
Effingham 1D,1D,20,241,665,0,926
Effingham 2A,2A,18,312,611,0,941
Effingham 2B,2B,17,305,404,0,726
Effingham 2C,2C,25,476,469,1,971
Effingham 2D,2D,25,595,645,1,1266
Effingham 3A,3A,9,251,360,0,620
Effingham 3B,3B,26,492,460,0,978
Effingham 3C,3C,16,297,252,0,565
Effingham 3D,3D,14,616,534,0,1164
Effingham 3E,3E,9,304,204,0,517
Effingham 4A,4A,30,877,552,0,1459
Effingham 4B,4B,17,342,323,2,684
Effingham 4C,4C,15,520,353,0,888
Effingham 5A,5A,34,548,587,0,1169
Effingham 5B,5B,23,366,373,0,762
Effingham 5C,5C,11,416,363,0,790
Effingham 5D,5D,5,328,329,0,662
Elbert Elberton,Elberton,44,685,297,0,1026
Elbert Longstreet,Longstreet,11,151,166,1,329
Elbert Eliam,Eliam,19,181,206,1,407
Elbert Petersburg,Petersburg,3,71,152,0,226
Elbert Wyche,Wyche,22,306,211,1,540
Elbert Moss-Ruckersville,Moss-Ruckersville,9,103,96,0,208
Elbert Pike,Pike,14,280,309,2,605
Elbert Gaines,Gaines,7,93,234,0,334
Elbert Goshen,Goshen,12,286,505,1,804
Elbert Webbsboro,Webbsboro,2,87,102,0,191
Elbert Centerville,Centerville,13,197,255,0,465
Emanuel Adrian,Adrian,12,119,238,1,370
Emanuel Blundale,Blundale,7,173,306,1,487
Emanuel Canoochee,Canoochee,5,115,236,0,356
Emanuel Cross-Green,Cross-Green,3,5,45,0,53
Emanuel Garfiled,Garfiled,3,49,203,0,255
Emanuel Nunez,Nunez,3,60,123,0,186
Emanuel Oak Park,Oak Park,6,69,278,0,353
Emanuel Stillmore,Stillmore,2,64,155,0,221
Emanuel Summerton,Summerton,1,53,161,0,215
Emanuel Swainsboro,Swainsboro,105,1255,845,4,2209
Emanuel Twin City,Twin City,22,208,393,1,624
Evans Veterans Community Center,Veterans Community Center,125,1419,770,0,2314
Fannin Colwell,Colwell,30,253,329,0,612
Fannin Fairplay,Fairplay,26,261,312,0,599
Fannin Flinthill,Flinthill,79,578,794,2,1453
Fannin Hemptown,Hemptown,25,272,412,0,709
Fannin Hothouse,Hothouse,35,279,310,3,627
Fannin Mineral Bluff,Mineral Bluff,47,528,436,1,1012
Fannin Mobile,Mobile,28,191,372,0,591
Fannin Morganton,Morganton,57,433,569,2,1061
Fannin Noontootla,Noontootla,16,199,245,1,461
Fannin Skeniah,Skeniah,7,51,115,0,173
Fannin Sugar Creek,Sugar Creek,84,636,480,2,1202
Fannin Toccoa,Toccoa,106,849,578,3,1536
Fayette Blackrock,Blackrock,33,262,133,0,428
Fayette Brooks,Brooks,43,648,865,0,1556
Fayette Europe,Europe,14,138,74,0,226
Fayette Fayetteville East,Fayetteville East,28,281,126,1,436
Fayette Fayetteville West,Fayetteville West,29,277,148,1,455
Fayette Flint,Flint,12,180,140,0,332
Fayette Hopeful,Hopeful,20,274,173,1,468
Fayette Morning Creek,Morning Creek,50,417,207,0,674
Fayette Rareover,Rareover,31,862,292,0,1185
Fayette Sandy Creek,Sandy Creek,24,736,293,1,1054
Fayette Shakerag East,Shakerag East,14,293,278,1,586
Fayette Shakerag West,Shakerag West,10,371,129,0,510
Fayette Starrs Mill,Starrs Mill,74,929,610,0,1613
Fayette Whitewater,Whitewater,74,986,522,0,1582
Fayette Woolsey,Woolsey,64,654,586,0,1304
Fayette McIntosh,McIntosh,51,891,395,0,1337
Fayette Oak Grove,Oak Grove,8,259,227,0,494
Fayette Kedron,Kedron,44,1182,599,1,1826
Fayette Aberdeen,Aberdeen,18,451,251,0,720
Fayette Windgate,Windgate,9,212,187,2,410
Fayette Flat Creek,Flat Creek,47,394,250,0,691
Fayette Braelinn,Braelinn,28,532,356,0,916
Fayette Kenwood,Kenwood,11,56,52,0,119
Fayette Banks,Banks,34,231,150,0,415
Fayette Harps Crossing,Harps Crossing,27,310,287,0,624
Fayette Willow Pond,Willow Pond,41,517,323,0,881
Fayette Dogwood,Dogwood,42,873,418,0,1333
Fayette Oak Ridge,Oak Ridge,25,274,215,0,514
Fayette Jeff Davis,Jeff Davis,44,294,129,0,467
Fayette Murphy,Murphy,50,571,299,0,920
Fayette Fielding Ridge,Fielding Ridge,37,864,425,0,1326
Fayette Willowbend,Willowbend,22,463,257,0,742
Fayette Camp Creek,Camp Creek,15,498,307,1,821
Fayette Rising Star,Rising Star,47,1136,629,0,1812
Fayette Spring Hill,Spring Hill,32,494,209,0,735
Fayette Antioch,Antioch,27,315,324,0,666
Floyd Alto Park,Alto Park,53,827,538,3,1421
Floyd Armuchee,Armuchee,13,203,416,0,632
Floyd Barkers,Barkers,20,521,571,0,1112
Floyd Cave Spring,Cave Spring,8,121,529,3,661
Floyd Chulio,Chulio,15,183,367,2,567
Floyd Etowah,Etowah,77,1277,923,5,2282
Floyd Everett Springs,Everett Springs,0,41,175,0,216
Floyd Floyd Springs,Floyd Springs,25,262,609,2,898
Floyd Fosters Mill,Fosters Mill,8,146,358,0,512
Floyd Garden Lakes,Garden Lakes,21,399,255,0,675
Floyd Glenwood,Glenwood,42,513,715,0,1270
Floyd Howell,Howell,19,235,551,0,805
Floyd East Lindale,East Lindale,27,632,684,2,1345
Floyd Mt Alto North,Mt Alto North,77,776,386,0,1239
Floyd Mt Alto South,Mt Alto South,54,555,470,1,1080
Floyd North Carolina,North Carolina,26,317,415,0,758
Floyd Riverside,Riverside,7,104,220,0,331
Floyd East Rome,East Rome,25,626,356,3,1010
Floyd North Rome,North Rome,42,519,292,0,853
Floyd South Rome,South Rome,7,64,47,0,118
Floyd Texas Valley,Texas Valley,6,88,287,0,381
Floyd Vanns Valley,Vanns Valley,12,99,180,0,291
Floyd Watters,Watters,50,683,863,7,1603
Floyd West Lindale,West Lindale,39,437,594,1,1071
Floyd Town Rome,Town Rome,36,466,290,0,792
Forsyth 01 Big Creek,01 Big Creek,117,1923,945,0,2985
Forsyth 02 Brandywine,02 Brandywine,38,388,611,0,1037
Forsyth 04 Chestatee,04 Chestatee,66,1289,713,3,2071
Forsyth 05 Coal Mountain,05 Coal Mountain,82,1936,1051,1,3070
Forsyth 06 Crossroads,06 Crossroads,72,2118,980,0,3170
Forsyth 07 Cumming,07 Cumming,131,1886,708,5,2730
Forsyth 08 Mashburn,08 Mashburn,144,1670,785,1,2600
Forsyth 10 Midway,10 Midway,144,3075,1096,1,4316
Forsyth 15 Heardsville,15 Heardsville,101,1736,966,3,2806
Forsyth 16 Otwell,16 Otwell,138,2518,953,4,3613
Forsyth 19 Old Atlanta,19 Old Atlanta,51,626,662,2,1341
Forsyth 21 South Forsyth,21 South Forsyth,29,647,272,0,948
Forsyth 25 Windermere,25 Windermere,98,1403,1092,1,2594
Forsyth 27 Concord,27 Concord,124,3333,1669,3,5129
Forsyth 34 Fowler,34 Fowler,100,1580,732,0,2412
Forsyth 35 Johns Creek,35 Johns Creek,105,1319,661,1,2086
Forsyth 36 Nichols,36 Nichols,71,1568,753,0,2392
Forsyth 38 Daves Creek,38 Daves Creek,117,1883,766,2,2768
Forsyth 39 Mathis,39 Mathis,83,1223,477,0,1783
Forsyth 40 West Forsyth,40 West Forsyth,80,1973,909,8,2970
Forsyth 41 Grassland,41 Grassland,28,768,381,3,1180
Forsyth 42 Keith Bridge,42 Keith Bridge,59,1177,684,2,1922
Forsyth 43 Lakeland,43 Lakeland,100,1026,572,0,1698
Forsyth 44 Lanier,44 Lanier,85,1253,700,3,2041
Forsyth 45 Mountainside,45 Mountainside,71,1592,728,1,2392
Forsyth 46 Sawmill Branch,46 Sawmill Branch,43,1045,525,0,1613
Forsyth 47 Riverclub,47 Riverclub,23,485,580,1,1089
Forsyth 49 Cheatam Creek,49 Cheatam Creek,50,858,348,1,1257
Franklin Carnesville,Carnesville,37,727,544,0,1308
Franklin West Franklin,West Franklin,25,437,420,0,882
Franklin Northeast Franklin,Northeast Franklin,76,619,733,0,1428
Franklin Lavonia,Lavonia,28,459,477,0,964
Franklin Canon,Canon,14,263,356,0,633
Franklin Royston,Royston,44,389,426,0,859
Franklin Southwest Franklin,Southwest Franklin,40,607,653,0,1300
Fulton 01A,01A,5,94,62,0,161
Fulton 01B,01B,5,73,135,0,213
Fulton 01C,01C,0,7,12,0,19
Fulton 01D,01D,0,12,24,0,36
Fulton 01E,01E,16,88,97,0,201
Fulton 01F,01F,0,5,4,0,9
Fulton 01G,01G,1,20,41,0,62
Fulton 01H,01H,0,5,4,0,9
Fulton 01I,01I,0,0,0,0,0
Fulton 01J,01J,5,20,12,0,37
Fulton 01P,01P,0,3,11,0,14
Fulton 01R,01R,0,1,7,0,8
Fulton 01S,01S,3,14,25,0,42
Fulton 01T,01T,3,26,22,0,51
Fulton 02A,02A,12,184,74,1,271
Fulton 02A1,02A1,7,113,52,0,172
Fulton 02B,02B,3,40,46,0,89
Fulton 02C,02C,2,26,25,0,53
Fulton 02D,02D,7,121,122,1,251
Fulton 02E,02E,3,31,55,0,89
Fulton 02F1,02F1,6,116,72,0,194
Fulton 02F2,02F2,0,25,16,0,41
Fulton 02G,02G,9,126,105,0,240
Fulton 02J,02J,10,42,47,1,100
Fulton 02K,02K,4,58,39,1,102
Fulton 02L1,02L1,16,208,124,0,348
Fulton 02L1A,02L1A,10,50,56,1,117
Fulton 02L2,02L2,4,84,60,0,148
Fulton 02S,02S,0,12,5,0,17
Fulton 02W,02W,4,24,17,0,45
Fulton 03A,03A,1,14,11,1,27
Fulton 03B,03B,0,3,1,0,4
Fulton 03C,03C,1,11,9,0,21
Fulton 03D,03D,0,6,5,0,11
Fulton 03E,03E,0,11,19,0,30
Fulton 03F,03F,4,64,52,0,120
Fulton 03G,03G,0,1,9,0,10
Fulton 03H,03H,0,8,2,0,10
Fulton 03I,03I,0,30,15,0,45
Fulton 03L,03L,0,4,10,0,14
Fulton 03M,03M,1,16,50,0,67
Fulton 03N,03N,2,11,33,0,46
Fulton 03P1A,03P1A,8,86,94,2,190
Fulton 03P1B,03P1B,0,0,0,0,0
Fulton 03P2,03P2,0,0,0,0,0
Fulton 03S,03S,1,6,6,1,14
Fulton 03T,03T,0,13,15,0,28
Fulton 04A,04A,2,3,7,1,13
Fulton 04B,04B,1,11,14,0,26
Fulton 04C,04C,0,0,0,0,0
Fulton 04D,04D,1,9,18,0,28
Fulton 04F,04F,1,37,25,1,64
Fulton 04G,04G,0,6,7,0,13
Fulton 04I,04I,3,10,12,0,25
Fulton 04J,04J,0,2,3,0,5
Fulton 04K,04K,1,8,9,0,18
Fulton 04L,04L,1,17,13,0,31
Fulton 04M,04M,1,1,5,0,7
Fulton 04S,04S,0,15,12,0,27
Fulton 04T,04T,0,9,10,0,19
Fulton 04V,04V,0,13,18,0,31
Fulton 04W,04W,0,2,1,0,3
Fulton 04X1,04X1,0,24,12,0,36
Fulton 04X2,04X2,0,2,10,0,12
Fulton 05A1,05A1,6,67,74,0,147
Fulton 05A2,05A2,5,72,58,1,136
Fulton 05B,05B,3,17,11,0,31
Fulton 05C,05C,1,0,0,0,1
Fulton 05D,05D,1,3,2,0,6
Fulton 05F,05F,0,1,2,0,3
Fulton 05J,05J,4,13,10,0,27
Fulton 05K,05K,0,24,14,0,38
Fulton 06B,06B,6,77,67,0,150
Fulton 06D,06D,19,126,117,0,262
Fulton 06D1,06D1,23,247,140,0,410
Fulton 06D2,06D2,16,167,97,1,281
Fulton 06E,06E,12,79,88,1,180
Fulton 06F,06F,7,150,68,0,225
Fulton 06G,06G,1,18,17,0,36
Fulton 06I,06I,3,64,56,0,123
Fulton 06J,06J,13,131,107,2,253
Fulton 06L1,06L1,13,95,39,0,147
Fulton 06L2,06L2,5,84,48,0,137
Fulton 06N,06N,12,190,94,0,296
Fulton 06Q,06Q,0,10,7,0,17
Fulton 06R,06R,10,143,44,0,197
Fulton 07A,07A,19,435,197,0,651
Fulton 07A1,07A1,55,480,214,1,750
Fulton 07B,07B,28,704,341,1,1074
Fulton 07C,07C,111,538,198,1,848
Fulton 07D,07D,20,299,147,0,466
Fulton 07D1,07D1,8,174,105,0,287
Fulton 07E,07E,25,229,104,0,358
Fulton 07F,07F,29,455,262,2,748
Fulton 07H,07H,23,353,140,0,516
Fulton 07J,07J,25,356,212,0,593
Fulton 07M,07M,13,150,91,1,255
Fulton 07N,07N,5,55,46,0,106
Fulton 08A,08A,39,600,206,1,846
Fulton 08B,08B,29,831,238,1,1099
Fulton 08C,08C,1,100,12,0,113
Fulton 08C1,08C1,20,355,96,1,472
Fulton 08D,08D,19,362,68,0,449
Fulton 08E,08E,40,664,202,0,906
Fulton 08F1,08F1,21,601,173,0,795
Fulton 08F2,08F2,0,0,0,0,0
Fulton 08G,08G,43,363,130,0,536
Fulton 08H,08H,41,659,165,0,865
Fulton 08J,08J,15,493,246,0,754
Fulton 08K,08K,2,110,92,0,204
Fulton 08L,08L,21,365,209,1,596
Fulton 08M,08M,19,513,262,2,796
Fulton 08N1,08N1,6,225,54,0,285
Fulton 08N2,08N2,31,241,78,0,350
Fulton 08P,08P,4,55,56,0,115
Fulton 09A,09A,13,260,178,0,451
Fulton 09B,09B,0,3,1,0,4
Fulton 09C,09C,3,19,19,0,41
Fulton 09D,09D,0,14,12,0,26
Fulton 09E,09E,4,47,32,0,83
Fulton 09F,09F,23,551,222,0,796
Fulton 09G,09G,16,186,138,0,340
Fulton 09H,09H,2,32,23,0,57
Fulton 09I,09I,1,11,12,0,24
Fulton 09K,09K,0,14,15,0,29
Fulton 09K1,09K1,2,28,14,0,44
Fulton 09M,09M,3,131,83,0,217
Fulton 10A,10A,1,18,21,0,40
Fulton 10B,10B,1,31,26,0,58
Fulton 10C,10C,0,4,11,0,15
Fulton 10D,10D,0,4,0,0,4
Fulton 10D2,10D2,0,5,2,0,7
Fulton 10D1,10D1,1,15,5,0,21
Fulton 10E,10E,0,6,5,1,12
Fulton 10F,10F,0,7,11,0,18
Fulton 10G,10G,1,10,8,0,19
Fulton 10H1,10H1,0,1,2,0,3
Fulton 10H2,10H2,5,11,11,0,27
Fulton 10I,10I,0,1,6,0,7
Fulton 10J,10J,1,2,13,0,16
Fulton 10K,10K,1,24,11,0,36
Fulton 10M,10M,3,15,19,1,38
Fulton 10P,10P,0,5,8,0,13
Fulton 10R,10R,0,1,2,0,3
Fulton 11B,11B,0,17,12,0,29
Fulton 11B2,11B2,0,0,1,0,1
Fulton 11B1,11B1,0,15,10,0,25
Fulton 11C,11C,0,2,0,0,2
Fulton 11C2,11C2,1,10,7,0,18
Fulton 11C3,11C3,0,8,5,0,13
Fulton 11E1,11E1,0,8,8,0,16
Fulton 11E2,11E2,0,6,5,0,11
Fulton 11E3,11E3,1,20,19,0,40
Fulton 11G,11G,0,19,7,0,26
Fulton 11H,11H,1,6,10,0,17
Fulton 11J,11J,2,13,11,1,27
Fulton 11K,11K,0,23,7,0,30
Fulton 11M,11M,2,13,6,0,21
Fulton 11M1,11M1,0,10,8,0,18
Fulton 11N,11N,6,23,14,0,43
Fulton 11P,11P,2,8,8,0,18
Fulton 11R,11R,0,6,4,1,11
Fulton 12A,12A,0,34,21,0,55
Fulton 12A1,12A1,2,33,37,0,72
Fulton 12D,12D,0,10,11,0,21
Fulton 12E1,12E1,2,10,6,0,18
Fulton 12E2,12E2,0,0,0,0,0
Fulton 12F,12F,0,5,8,0,13
Fulton 12G,12G,0,6,4,0,10
Fulton 12H1,12H1,1,4,2,0,7
Fulton 12H2,12H2,1,11,18,0,30
Fulton 12I,12I,0,4,3,0,7
Fulton 12J,12J,5,18,27,0,50
Fulton 12K,12K,0,31,20,0,51
Fulton 12L,12L,1,3,3,0,7
Fulton 12M,12M,1,15,13,0,29
Fulton 12N,12N,2,5,2,0,9
Fulton 12S,12S,0,13,5,1,19
Fulton AP01A,AP01A,60,928,360,2,1350
Fulton AP01B,AP01B,19,217,85,0,321
Fulton AP01C,AP01C,17,488,157,0,662
Fulton AP01D,AP01D,11,121,78,0,210
Fulton AP01E,AP01E,0,0,0,0,0
Fulton AP021,AP021,20,659,298,1,978
Fulton AP022,AP022,16,283,184,0,483
Fulton AP023,AP023,13,130,44,0,187
Fulton AP02B,AP02B,13,94,44,0,151
Fulton AP03,AP03,0,36,28,0,64
Fulton AP04A,AP04A,22,391,178,0,591
Fulton AP04B,AP04B,6,96,37,0,139
Fulton AP05,AP05,51,953,437,0,1441
Fulton AP06,AP06,16,454,220,0,690
Fulton AP07A,AP07A,44,694,329,1,1068
Fulton AP07C,AP07C,9,246,98,0,353
Fulton AP07B,AP07B,6,131,74,0,211
Fulton AP09A,AP09A,46,727,322,1,1096
Fulton AP09B,AP09B,2,117,52,0,171
Fulton AP10,AP10,6,249,104,0,359
Fulton AP12A,AP12A,3,52,54,0,109
Fulton AP12B,AP12B,22,86,72,1,181
Fulton AP12C,AP12C,26,560,202,1,789
Fulton AP12D,AP12D,0,0,0,0,0
Fulton AP14,AP14,1,13,3,0,17
Fulton AP14A,AP14A,26,645,217,1,889
Fulton CH01,CH01,1,27,13,0,41
Fulton CH02,CH02,2,65,44,1,112
Fulton CH03,CH03,3,77,77,3,160
Fulton CH04A,CH04A,3,183,73,1,260
Fulton CH04B,CH04B,0,1,0,0,1
Fulton CH05,CH05,0,110,68,0,178
Fulton CP011,CP011,7,54,26,0,87
Fulton CP012,CP012,0,74,21,0,95
Fulton CP01B,CP01B,0,45,9,0,54
Fulton CP02,CP02,6,34,22,0,62
Fulton CP04A,CP04A,0,2,0,0,2
Fulton CP04B,CP04B,0,0,1,0,1
Fulton CP051,CP051,0,0,1,0,1
Fulton CP05C,CP05C,1,13,11,0,25
Fulton CP052,CP052,0,0,0,0,0
Fulton CP05B,CP05B,0,3,0,0,3
Fulton CP06A,CP06A,0,3,1,0,4
Fulton CP06B,CP06B,0,0,0,0,0
Fulton CP07A,CP07A,1,2,4,0,7
Fulton CP07B,CP07B,0,0,0,0,0
Fulton CP07C,CP07C,0,1,0,0,1
Fulton CP07D,CP07D,0,0,0,0,0
Fulton CP07E,CP07E,0,1,0,0,1
Fulton CP07F,CP07F,0,0,1,0,1
Fulton CP081,CP081,0,1,2,0,3
Fulton CP083,CP083,0,0,1,0,1
Fulton CP084,CP084,0,0,0,0,0
Fulton CP08A,CP08A,0,1,1,0,2
Fulton EP01A,EP01A,6,50,40,0,96
Fulton EP01B,EP01B,1,32,17,0,50
Fulton EP01C,EP01C,0,23,12,0,35
Fulton EP02A,EP02A,2,22,9,1,34
Fulton EP02B,EP02B,9,74,49,0,132
Fulton EP02C,EP02C,3,21,9,0,33
Fulton EP02D,EP02D,0,2,3,0,5
Fulton EP02E,EP02E,4,17,12,0,33
Fulton EP03A,EP03A,3,63,42,1,109
Fulton EP03B,EP03B,3,19,13,0,35
Fulton EP04A,EP04A,2,15,9,1,27
Fulton EP04B,EP04B,1,15,17,0,33
Fulton EP04C,EP04C,2,27,9,0,38
Fulton FA01A,FA01A,8,134,35,1,178
Fulton FA01B,FA01B,16,166,74,1,257
Fulton FA01C,FA01C,0,12,13,0,25
Fulton FA01D,FA01D,0,12,5,0,17
Fulton FC02,FC02,0,3,2,0,5
Fulton HP01,HP01,9,161,213,0,383
Fulton JC01,JC01,10,554,254,2,820
Fulton JC01A,JC01A,9,191,163,0,363
Fulton JC02,JC02,19,400,235,2,656
Fulton JC03A,JC03A,3,93,52,1,149
Fulton JC03B,JC03B,6,182,124,0,312
Fulton JC04A,JC04A,16,602,165,1,784
Fulton JC04B,JC04B,4,49,13,0,66
Fulton JC04C,JC04C,7,165,85,0,257
Fulton JC05,JC05,8,342,153,0,503
Fulton JC06,JC06,31,479,224,0,734
Fulton JC07,JC07,35,645,332,0,1012
Fulton JC08,JC08,13,515,206,0,734
Fulton JC09,JC09,19,432,202,1,654
Fulton JC10,JC10,15,319,166,4,504
Fulton JC11,JC11,29,718,273,1,1021
Fulton JC12,JC12,35,830,249,0,1114
Fulton JC13A,JC13A,17,637,202,0,856
Fulton JC13B,JC13B,0,91,30,0,121
Fulton JC14,JC14,24,592,159,0,775
Fulton JC15,JC15,5,103,72,0,180
Fulton JC16,JC16,13,452,224,0,689
Fulton JC18,JC18,22,676,240,0,938
Fulton JC19A,JC19A,20,522,164,0,706
Fulton JC19,JC19,20,202,104,0,326
Fulton ML01A,ML01A,28,713,271,2,1014
Fulton ML01B,ML01B,8,171,72,0,251
Fulton ML01C,ML01C,1,37,17,0,55
Fulton ML02A,ML02A,29,756,399,0,1184
Fulton ML02B,ML02B,11,569,208,0,788
Fulton ML03,ML03,42,1037,329,1,1409
Fulton ML03A,ML03A,4,169,87,1,261
Fulton ML04,ML04,43,844,398,2,1287
Fulton ML05,ML05,48,893,430,1,1372
Fulton ML06A,ML06A,13,153,129,0,295
Fulton ML06B,ML06B,18,296,216,0,530
Fulton ML07A,ML07A,6,202,142,0,350
Fulton ML07B,ML07B,26,393,246,0,665
Fulton MP01,MP01,3,24,122,0,149
Fulton PA01,PA01,13,194,60,0,267
Fulton RW01,RW01,101,1125,535,1,1762
Fulton RW02,RW02,35,805,416,0,1256
Fulton RW03,RW03,5,110,44,0,159
Fulton RW03B,RW03B,17,248,139,0,404
Fulton RW03A,RW03A,9,109,53,0,171
Fulton RW03C,RW03C,8,222,111,0,341
Fulton RW04,RW04,21,365,153,0,539
Fulton RW05,RW05,17,199,157,1,374
Fulton RW05A,RW05A,5,67,35,1,108
Fulton RW06,RW06,18,460,271,0,749
Fulton RW07A,RW07A,1,38,35,0,74
Fulton RW07B,RW07B,3,18,34,0,55
Fulton RW08,RW08,57,515,263,0,835
Fulton RW09,RW09,55,934,571,0,1560
Fulton RW09A,RW09A,30,596,315,0,941
Fulton RW10,RW10,26,652,297,0,975
Fulton RW10A,RW10A,18,255,65,0,338
Fulton RW11A,RW11A,25,480,203,2,710
Fulton RW11B,RW11B,0,0,0,0,0
Fulton RW12,RW12,24,642,442,0,1108
Fulton RW12A,RW12A,33,683,323,0,1039
Fulton RW13,RW13,24,709,361,0,1094
Fulton RW16,RW16,23,393,274,0,690
Fulton RW17,RW17,13,355,183,0,551
Fulton RW19,RW19,24,411,294,0,729
Fulton RW20,RW20,18,631,158,0,807
Fulton RW21,RW21,7,66,1,0,74
Fulton RW21A,RW21A,24,786,223,0,1033
Fulton RW22A,RW22A,16,547,214,1,778
Fulton RW22C,RW22C,0,0,0,0,0
Fulton RW22B,RW22B,0,0,0,0,0
Fulton SC01A,SC01A,0,2,2,0,4
Fulton SC01B,SC01B,1,19,7,0,27
Fulton SC01C,SC01C,6,24,9,0,39
Fulton SC02,SC02,1,12,3,0,16
Fulton SC02A,SC02A,4,12,1,0,17
Fulton SC04,SC04,4,97,45,0,146
Fulton SC05A,SC05A,1,4,0,0,5
Fulton SC05B,SC05B,0,8,3,0,11
Fulton SC05C,SC05C,2,29,7,0,38
Fulton SC05D,SC05D,4,29,13,1,47
Fulton SC05E,SC05E,0,31,14,0,45
Fulton SC07A,SC07A,8,141,44,0,193
Fulton SC07B,SC07B,0,0,0,0,0
Fulton SC07C,SC07C,0,0,0,0,0
Fulton SC07D,SC07D,0,4,4,0,8
Fulton SC07E,SC07E,2,57,14,0,73
Fulton SC08A,SC08A,0,0,0,0,0
Fulton SC08J,SC08J,0,0,0,0,0
Fulton SC08B,SC08B,2,39,23,0,64
Fulton SC08I,SC08I,1,3,0,0,4
Fulton SC08C,SC08C,0,0,0,0,0
Fulton SC08D,SC08D,1,2,3,0,6
Fulton SC08E,SC08E,0,4,5,0,9
Fulton SC08F,SC08F,2,5,1,0,8
Fulton SC08G,SC08G,0,0,0,0,0
Fulton SC08H,SC08H,0,0,0,0,0
Fulton SC09A,SC09A,0,16,8,0,24
Fulton SC09B,SC09B,3,22,5,0,30
Fulton SC09C,SC09C,2,18,11,0,31
Fulton SC10,SC10,1,13,9,0,23
Fulton SC11A,SC11A,3,10,14,0,27
Fulton SC11B,SC11B,2,16,9,0,27
Fulton SC13,SC13,1,35,15,0,51
Fulton SC13A,SC13A,0,13,4,0,17
Fulton SC14A,SC14A,0,6,9,0,15
Fulton SC15,SC15,4,50,24,0,78
Fulton SC15A,SC15A,5,28,9,0,42
Fulton SC16A,SC16A,0,19,15,0,34
Fulton SC16B,SC16B,1,20,5,0,26
Fulton SC17A,SC17A,0,0,0,0,0
Fulton SC17B,SC17B,0,0,0,0,0
Fulton SC17C,SC17C,0,11,11,0,22
Fulton SC18A,SC18A,0,5,5,0,10
Fulton SC18B,SC18B,1,15,3,0,19
Fulton SC18C,SC18C,3,27,7,0,37
Fulton SC18D,SC18D,0,8,4,0,12
Fulton SC19A,SC19A,0,5,0,0,5
Fulton SC19B,SC19B,1,11,16,0,28
Fulton SC20,SC20,0,19,10,0,29
Fulton SC211,SC211,2,30,17,0,49
Fulton SC212,SC212,6,55,39,1,101
Fulton SC21A,SC21A,0,0,0,0,0
Fulton SC23A,SC23A,0,24,34,0,58
Fulton SC23B,SC23B,0,9,1,0,10
Fulton SC23C,SC23C,4,19,17,0,40
Fulton SC27,SC27,1,30,11,0,42
Fulton SC29A,SC29A,4,16,14,1,35
Fulton SC29B,SC29B,0,0,0,0,0
Fulton SC30A,SC30A,0,0,1,0,1
Fulton SC30B,SC30B,0,6,9,0,15
Fulton SC31,SC31,0,1,0,0,1
Fulton SC32,SC32,0,1,2,0,3
Fulton SC33,SC33,0,1,0,0,1
Fulton SS01,SS01,66,795,427,1,1289
Fulton SS01A,SS01A,22,276,92,1,391
Fulton SS02A,SS02A,6,183,59,0,248
Fulton SS02B,SS02B,4,97,53,0,154
Fulton SS03A,SS03A,11,112,69,0,192
Fulton SS03,SS03,5,101,61,1,168
Fulton SS04A,SS04A,0,17,7,0,24
Fulton SS04,SS04,25,376,210,0,611
Fulton SS05,SS05,14,363,182,0,559
Fulton SS06,SS06,22,371,134,0,527
Fulton SS07A,SS07A,20,270,71,0,361
Fulton SS07B,SS07B,7,92,48,0,147
Fulton SS07C,SS07C,17,113,57,0,187
Fulton SS07D,SS07D,0,1,0,0,1
Fulton SS08A,SS08A,8,124,118,1,251
Fulton SS08B,SS08B,12,148,32,0,192
Fulton SS08E,SS08E,4,34,15,0,53
Fulton SS08C,SS08C,2,54,27,0,83
Fulton SS08D,SS08D,8,119,77,0,204
Fulton SS09A,SS09A,47,708,295,0,1050
Fulton SS09B,SS09B,64,827,266,2,1159
Fulton SS11A,SS11A,29,433,182,1,645
Fulton SS11B,SS11B,8,95,62,0,165
Fulton SS11C,SS11C,1,11,9,0,21
Fulton SS11D,SS11D,4,77,26,0,107
Fulton SS12,SS12,53,502,217,0,772
Fulton SS13A,SS13A,16,310,159,0,485
Fulton SS13B,SS13B,7,191,72,0,270
Fulton SS14,SS14,20,416,172,0,608
Fulton SS15A,SS15A,4,69,62,0,135
Fulton SS15B,SS15B,5,108,109,0,222
Fulton SS16,SS16,39,455,205,0,699
Fulton SS17,SS17,48,565,350,2,965
Fulton SS18A,SS18A,2,78,36,0,116
Fulton SS18C,SS18C,6,59,25,0,90
Fulton SS18B,SS18B,0,58,15,0,73
Fulton SS19A,SS19A,16,242,86,0,344
Fulton SS19B,SS19B,4,219,81,0,304
Fulton SS20,SS20,17,206,93,2,318
Fulton SS22,SS22,46,333,147,0,526
Fulton SS26,SS26,8,157,62,0,227
Fulton SS29A,SS29A,24,316,168,0,508
Fulton SS29B,SS29B,0,1,0,0,1
Fulton SS31,SS31,13,288,90,1,392
Fulton UC01A,UC01A,0,32,13,0,45
Fulton UC01B,UC01B,0,2,2,0,4
Fulton UC01C,UC01C,0,0,0,0,0
Fulton UC01D,UC01D,0,1,1,0,2
Fulton UC01E,UC01E,0,3,2,0,5
Fulton UC02A,UC02A,2,4,3,0,9
Fulton UC02E,UC02E,1,22,26,0,49
Fulton UC02B,UC02B,0,2,0,0,2
Fulton UC02C,UC02C,0,1,0,0,1
Fulton UC02D,UC02D,5,77,17,2,101
Fulton UC031,UC031,9,89,30,0,128
Fulton UC032,UC032,4,25,10,0,39
Fulton UC033,UC033,0,0,0,0,0
Fulton UC035,UC035,0,1,0,0,1
Gilmer Ellijay South,Ellijay South,57,876,471,1,1405
Gilmer Cartecay,Cartecay,30,406,455,1,892
Gilmer Tails Creek,Tails Creek,22,347,467,1,837
Gilmer Town Creek,Town Creek,13,229,362,0,604
Gilmer Leaches,Leaches,60,718,626,3,1407
Gilmer Cherry Log,Cherry Log,15,166,279,0,460
Gilmer Boardtown,Boardtown,41,428,369,1,839
Gilmer Mountaintown,Mountaintown,23,258,319,0,600
Gilmer East Ellijay,East Ellijay,47,496,328,1,872
Gilmer Ellijay North,Ellijay North,42,419,353,2,816
Gilmer Yukon,Yukon,22,251,411,0,684
Gilmer Roy Road,Roy Road,16,366,409,0,791
Gilmer Ellijay Northeast,Ellijay Northeast,64,568,320,0,952
Glascock Edgehill,Edgehill,2,28,59,0,89
Glascock Gibson,Gibson,16,221,120,0,357
Glascock Mill,Mill,18,226,190,0,434
Glascock Mitchell,Mitchell,10,110,171,0,291
Glynn SES,SES,54,1174,655,1,1884
Glynn BRK,BRK,26,687,650,0,1363
Glynn MAR,MAR,27,609,497,1,1134
Glynn BLY,BLY,35,693,452,1,1181
Glynn NSSI,NSSI,101,1756,663,6,2526
Glynn CSSI,CSSI,130,2292,675,5,3102
Glynn SSSI,SSSI,86,1533,396,2,2017
Glynn JI,JI,25,59,193,1,278
Glynn COG,COG,40,655,504,1,1200
Glynn SEB,SEB,14,354,266,1,635
Glynn GICCA,GICCA,46,581,442,3,1072
Glynn NGLY,NGLY,32,690,543,0,1265
Glynn BAL,BAL,52,614,269,1,936
Glynn NSB,NSB,36,271,251,0,558
Glynn THE,THE,29,279,177,0,485
Glynn CPM,CPM,24,221,135,1,381
Glynn HCP,HCP,23,245,218,0,486
Glynn UPP,UPP,12,45,33,0,90
Glynn ARCO,ARCO,3,84,53,2,142
Gordon Sugar Valley,Sugar Valley,11,269,443,1,724
Gordon Plainville,Plainville,12,321,494,3,830
Gordon Sonoraville,Sonoraville,51,1097,1379,0,2527
Gordon Pine Chapel,Pine Chapel,12,183,341,0,536
Gordon Oostanaula,Oostanaula,9,100,208,0,317
Gordon Oakman,Oakman,16,145,464,1,626
Gordon Gordon County,Gordon County,73,1256,1045,2,2376
Gordon Calhoun City,Calhoun City,129,1911,1146,3,3189
Gordon Lily Pond,Lily Pond,18,434,450,0,902
Gordon Fairmount,Fairmount,34,242,717,0,993
Gordon Red Bud,Red Bud,21,567,732,1,1321
Gordon Resaca,Resaca,17,192,405,0,614
Grady Blowing Cave,Blowing Cave,10,152,275,0,437
Grady Cairo 4th District,Cairo 4th District,17,155,48,2,222
Grady Cairo 5th District,Cairo 5th District,33,432,301,0,766
Grady Duncanville ,Duncanville ,10,72,113,0,195
Grady Higdon,Higdon,8,124,243,0,375
Grady Limesink,Limesink,4,62,98,0,164
Grady Midway,Midway,23,299,291,1,614
Grady Pine Park ,Pine Park ,10,126,202,0,338
Grady Ragan,Ragan,9,106,126,0,241
Grady Spence,Spence,10,120,252,0,382
Grady Spring Hill,Spring Hill,5,144,152,0,301
Grady Whigham,Whigham,10,199,289,0,498
Grady Woodland,Woodland,34,647,424,0,1105
Greene Greensboro,Greensboro,41,770,297,0,1108
Greene Union Point,Union Point,10,235,222,0,467
Greene Siloam,Siloam,7,147,124,0,278
Greene White Plains,White Plains,6,78,60,0,144
Greene Old Salem,Old Salem,242,3428,1073,1,4744
Gwinnett HARBINS A,HARBINS A,78,1034,548,1,1661
Gwinnett ROCKBRIDGE A,ROCKBRIDGE A,29,205,142,0,376
Gwinnett DACULA,DACULA,33,592,325,0,950
Gwinnett SUWANEE A,SUWANEE A,23,274,153,0,450
Gwinnett BAYCREEK A,BAYCREEK A,40,302,409,0,751
Gwinnett GOODWINS A,GOODWINS A,43,329,316,0,688
Gwinnett DULUTH A,DULUTH A,54,652,386,0,1092
Gwinnett DUNCANS A,DUNCANS A,70,1020,567,1,1658
Gwinnett PUCKETTS A,PUCKETTS A,82,1468,550,0,2100
Gwinnett CATES A,CATES A,50,351,257,1,659
Gwinnett BERKSHIRE A,BERKSHIRE A,18,144,189,0,351
Gwinnett BERKSHIRE B,BERKSHIRE B,55,379,166,0,600
Gwinnett DUNCANS C,DUNCANS C,37,625,520,0,1182
Gwinnett GARNERS A,GARNERS A,51,562,326,0,939
Gwinnett LAWRENCEVILLE A,LAWRENCEVILLE A,45,372,275,1,693
Gwinnett LAWRENCEVILLE B,LAWRENCEVILLE B,52,323,285,0,660
Gwinnett MARTINS A,MARTINS A,4,102,151,0,257
Gwinnett MARTINS B,MARTINS B,25,170,207,0,402
Gwinnett MARTINS C,MARTINS C,20,191,250,0,461
Gwinnett PINCKNEYVILLE A,PINCKNEYVILLE A,5,67,100,0,172
Gwinnett PINCKNEYVILLE B,PINCKNEYVILLE B,18,137,134,0,289
Gwinnett PINCKNEYVILLE C,PINCKNEYVILLE C,42,250,307,1,600
Gwinnett PINCKNEYVILLE D,PINCKNEYVILLE D,6,72,86,1,165
Gwinnett SUGAR HILL A,SUGAR HILL A,33,531,580,1,1145
Gwinnett SUGAR HILL B,SUGAR HILL B,69,706,792,1,1568
Gwinnett HOG MOUNTAIN A,HOG MOUNTAIN A,36,419,419,1,875
Gwinnett HOG MOUNTAIN B,HOG MOUNTAIN B,61,716,519,0,1296
Gwinnett ROCKYCREEK A,ROCKYCREEK A,59,978,627,0,1664
Gwinnett CATES B,CATES B,30,202,228,1,461
Gwinnett CATES C,CATES C,28,216,191,0,435
Gwinnett HOG MOUNTAIN D,HOG MOUNTAIN D,34,389,355,0,778
Gwinnett BERKSHIRE D,BERKSHIRE D,42,361,264,0,667
Gwinnett BERKSHIRE E,BERKSHIRE E,28,316,206,0,550
Gwinnett BERKSHIRE F,BERKSHIRE F,19,100,202,1,322
Gwinnett CATES D,CATES D,41,378,358,1,778
Gwinnett CATES E,CATES E,38,416,347,0,801
Gwinnett PINCKNEYVILLE E,PINCKNEYVILLE E,8,56,88,1,153
Gwinnett PINCKNEYVILLE F,PINCKNEYVILLE F,8,153,134,0,295
Gwinnett DUNCANS D,DUNCANS D,92,1655,816,0,2563
Gwinnett PINCKNEYVILLE H,PINCKNEYVILLE H,56,710,344,0,1110
Gwinnett BAYCREEK B,BAYCREEK B,29,389,424,0,842
Gwinnett LAWRENCEVILLE C,LAWRENCEVILLE C,50,366,342,0,758
Gwinnett MARTINS D,MARTINS D,18,71,94,0,183
Gwinnett ROCKBRIDGE B,ROCKBRIDGE B,29,227,181,0,437
Gwinnett GARNERS B,GARNERS B,34,314,122,0,470
Gwinnett CATES F,CATES F,28,226,282,0,536
Gwinnett CATES G,CATES G,67,447,363,0,877
Gwinnett DULUTH B,DULUTH B,63,404,298,0,765
Gwinnett GARNERS C,GARNERS C,16,187,166,1,370
Gwinnett PINCKNEYVILLE I,PINCKNEYVILLE I,15,128,76,0,219
Gwinnett PINCKNEYVILLE J,PINCKNEYVILLE J,8,56,57,0,121
Gwinnett BERKSHIRE G,BERKSHIRE G,35,407,197,0,639
Gwinnett CATES H,CATES H,22,244,179,0,445
Gwinnett SUGAR HILL C,SUGAR HILL C,58,730,834,0,1622
Gwinnett SUGAR HILL D,SUGAR HILL D,46,798,503,3,1350
Gwinnett DULUTH C,DULUTH C,24,250,188,0,462
Gwinnett DULUTH D,DULUTH D,44,411,299,0,754
Gwinnett PINCKNEYVILLE K,PINCKNEYVILLE K,18,117,148,0,283
Gwinnett PINCKNEYVILLE N,PINCKNEYVILLE N,5,122,110,0,237
Gwinnett LAWRENCEVILLE D,LAWRENCEVILLE D,34,208,156,0,398
Gwinnett LAWRENCEVILLE E,LAWRENCEVILLE E,50,276,235,0,561
Gwinnett PINCKNEYVILLE L,PINCKNEYVILLE L,50,466,397,0,913
Gwinnett PINCKNEYVILLE M,PINCKNEYVILLE M,65,617,422,0,1104
Gwinnett GARNERS D,GARNERS D,39,209,115,0,363
Gwinnett BERKSHIRE H,BERKSHIRE H,10,128,128,0,266
Gwinnett PINCKNEYVILLE O,PINCKNEYVILLE O,13,154,93,0,260
Gwinnett PUCKETTS E,PUCKETTS E,48,757,422,2,1229
Gwinnett CATES I,CATES I,28,336,390,0,754
Gwinnett CATES J,CATES J,47,338,295,0,680
Gwinnett GOODWINS B,GOODWINS B,47,554,460,0,1061
Gwinnett LAWRENCEVILLE F,LAWRENCEVILLE F,21,254,148,0,423
Gwinnett MARTINS E,MARTINS E,13,106,94,1,214
Gwinnett PINCKNEYVILLE P,PINCKNEYVILLE P,49,242,170,0,461
Gwinnett PINCKNEYVILLE Q,PINCKNEYVILLE Q,3,29,66,1,99
Gwinnett ROCKBRIDGE C,ROCKBRIDGE C,26,246,156,1,429
Gwinnett ROCKBRIDGE D,ROCKBRIDGE D,33,299,114,0,446
Gwinnett GOODWINS C,GOODWINS C,52,379,340,0,771
Gwinnett BAYCREEK K,BAYCREEK K,66,428,303,0,797
Gwinnett CATES K,CATES K,33,276,372,0,681
Gwinnett BAYCREEK C,BAYCREEK C,60,564,526,1,1151
Gwinnett CATES L,CATES L,66,431,260,0,757
Gwinnett DULUTH E,DULUTH E,21,401,261,0,683
Gwinnett GOODWINS D,GOODWINS D,46,364,454,0,864
Gwinnett LAWRENCEVILLE G,LAWRENCEVILLE G,17,165,191,0,373
Gwinnett LAWRENCEVILLE H,LAWRENCEVILLE H,71,472,456,0,999
Gwinnett MARTINS F,MARTINS F,10,103,121,0,234
Gwinnett PINCKNEYVILLE S,PINCKNEYVILLE S,30,264,219,1,514
Gwinnett ROCKBRIDGE E,ROCKBRIDGE E,13,213,167,2,395
Gwinnett SUGAR HILL E,SUGAR HILL E,39,492,426,0,957
Gwinnett LAWRENCEVILLE I,LAWRENCEVILLE I,44,239,212,0,495
Gwinnett BAYCREEK D,BAYCREEK D,54,444,489,0,987
Gwinnett BERKSHIRE J,BERKSHIRE J,47,433,279,0,759
Gwinnett CATES M,CATES M,66,511,455,0,1032
Gwinnett CATES N,CATES N,68,405,349,0,822
Gwinnett DULUTH F,DULUTH F,39,221,143,2,405
Gwinnett DULUTH G,DULUTH G,43,461,271,0,775
Gwinnett GOODWINS E,GOODWINS E,40,519,508,1,1068
Gwinnett GOODWINS F,GOODWINS F,33,299,282,0,614
Gwinnett PINCKNEYVILLE T,PINCKNEYVILLE T,26,240,255,0,521
Gwinnett SUWANEE B,SUWANEE B,49,865,300,0,1214
Gwinnett PINCKNEYVILLE U,PINCKNEYVILLE U,22,135,219,0,376
Gwinnett PUCKETTS B,PUCKETTS B,53,585,400,1,1039
Gwinnett BERKSHIRE L,BERKSHIRE L,20,151,167,2,340
Gwinnett ROCKBRIDGE F,ROCKBRIDGE F,40,346,108,0,494
Gwinnett SUGAR HILL F,SUGAR HILL F,31,541,538,0,1110
Gwinnett SUWANEE C,SUWANEE C,59,816,431,3,1309
Gwinnett CATES O,CATES O,20,138,249,0,407
Gwinnett BAYCREEK E,BAYCREEK E,32,268,251,0,551
Gwinnett BERKSHIRE M,BERKSHIRE M,20,271,197,1,489
Gwinnett MARTINS G,MARTINS G,11,82,150,0,243
Gwinnett DULUTH H,DULUTH H,55,364,221,0,640
Gwinnett BERKSHIRE N,BERKSHIRE N,41,638,204,0,883
Gwinnett PINCKNEYVILLE V,PINCKNEYVILLE V,16,119,129,0,264
Gwinnett PINCKNEYVILLE W,PINCKNEYVILLE W,28,508,319,0,855
Gwinnett MARTINS H,MARTINS H,52,285,357,0,694
Gwinnett MARTINS I,MARTINS I,39,162,215,0,416
Gwinnett MARTINS J,MARTINS J,14,142,151,1,308
Gwinnett GARNERS F,GARNERS F,25,246,137,0,408
Gwinnett BERKSHIRE O,BERKSHIRE O,41,353,340,1,735
Gwinnett BERKSHIRE P,BERKSHIRE P,15,91,111,0,217
Gwinnett PINCKNEYVILLE X,PINCKNEYVILLE X,64,535,304,0,903
Gwinnett ROCKBRIDGE G,ROCKBRIDGE G,23,312,169,1,505
Gwinnett PINCKNEYVILLE Y,PINCKNEYVILLE Y,4,97,118,0,219
Gwinnett GOODWINS G,GOODWINS G,18,128,192,0,338
Gwinnett PINCKNEYVILLE Z,PINCKNEYVILLE Z,30,360,333,0,723
Gwinnett PINCKNEYVILLE A1,PINCKNEYVILLE A1,60,577,407,0,1044
Gwinnett LAWRENCEVILLE J,LAWRENCEVILLE J,7,123,160,0,290
Gwinnett GOODWINS H,GOODWINS H,19,270,277,0,566
Gwinnett DUNCANS B,DUNCANS B,62,1006,889,1,1958
Gwinnett SUWANEE D,SUWANEE D,58,821,634,0,1513
Gwinnett SUWANEE E,SUWANEE E,51,783,451,0,1285
Gwinnett LAWRENCEVILLE K,LAWRENCEVILLE K,42,347,341,0,730
Gwinnett HARBINS B,HARBINS B,45,918,374,0,1337
Gwinnett BAYCREEK F,BAYCREEK F,40,301,346,0,687
Gwinnett PUCKETTS C,PUCKETTS C,46,563,409,1,1019
Gwinnett HOG MOUNTAIN C,HOG MOUNTAIN C,49,542,486,0,1077
Gwinnett ROCKYCREEK B,ROCKYCREEK B,42,678,513,1,1234
Gwinnett DULUTH I,DULUTH I,94,734,445,0,1273
Gwinnett MARTINS K,MARTINS K,28,173,293,1,495
Gwinnett SUWANEE H,SUWANEE H,54,883,496,2,1435
Gwinnett SUGAR HILL G,SUGAR HILL G,32,545,398,0,975
Gwinnett SUWANEE F,SUWANEE F,31,531,369,1,932
Gwinnett LAWRENCEVILLE L,LAWRENCEVILLE L,57,401,361,0,819
Gwinnett LAWRENCEVILLE M,LAWRENCEVILLE M,29,325,250,1,605
Gwinnett BAYCREEK G,BAYCREEK G,54,447,397,0,898
Gwinnett BAYCREEK H,BAYCREEK H,78,776,640,1,1495
Gwinnett BAYCREEK I,BAYCREEK I,61,502,433,0,996
Gwinnett BERKSHIRE Q,BERKSHIRE Q,18,203,216,1,438
Gwinnett GOODWINS I,GOODWINS I,22,277,298,1,598
Gwinnett DULUTH K,DULUTH K,9,84,67,0,160
Gwinnett HARBINS C,HARBINS C,23,324,520,0,867
Gwinnett ROCKYCREEK C,ROCKYCREEK C,41,834,470,0,1345
Gwinnett LAWRENCEVILLE N,LAWRENCEVILLE N,22,178,196,0,396
Gwinnett PUCKETTS D,PUCKETTS D,57,685,346,0,1088
Gwinnett SUWANEE G,SUWANEE G,29,460,392,0,881
Gwinnett BAYCREEK J,BAYCREEK J,40,279,287,0,606
Habersham Habersham North,Habersham North,177,3664,1061,0,4902
Habersham Habersham South,Habersham South,166,1657,918,4,2745
Habersham Demorest,Demorest,93,1744,681,0,2518
Habersham Town of Mount Airy,Town of Mount Airy,11,147,166,1,325
Habersham City of Baldwin,City of Baldwin,0,4,0,0,4
Habersham Mud Creek,Mud Creek,86,1220,811,2,2119
Habersham Amys Creek,Amys Creek,35,505,356,0,896
Hall Wilson,Wilson,211,1489,656,1,2357
Hall Chicopee,Chicopee,47,504,349,0,900
Hall Oakwood I,Oakwood I,27,325,320,0,672
Hall Oakwood II,Oakwood II,101,1131,764,1,1997
Hall Flowery Branch I,Flowery Branch I,72,1227,764,0,2063
Hall Flowery Branch II,Flowery Branch II,50,756,676,0,1482
Hall Roberts,Roberts,100,1553,929,0,2582
Hall Morgan I,Morgan I,50,1091,763,1,1905
Hall Morgan II,Morgan II,96,1169,609,1,1875
Hall Candler,Candler,62,1209,840,0,2111
Hall Tadmore,Tadmore,49,632,498,0,1179
Hall Glade,Glade,66,843,533,1,1443
Hall Lula,Lula,47,881,734,0,1662
Hall Clermont,Clermont,48,1253,751,0,2052
Hall Quillians,Quillians,38,1083,553,1,1675
Hall Bark Camp,Bark Camp,104,1738,830,0,2672
Hall Chestatee,Chestatee,79,1031,678,0,1788
Hall Fork,Fork,79,855,733,0,1667
Hall Whelchel,Whelchel,81,1309,601,1,1992
Hall West Whelchel,West Whelchel,178,1234,619,0,2031
Hall Gainesville I,Gainesville I,95,756,425,0,1276
Hall Gainesville II,Gainesville II,27,74,56,0,157
Hall Gainesville III,Gainesville III,49,325,337,0,711
Hall Gainesville IV,Gainesville IV,37,506,229,0,772
Hall Gainesville V,Gainesville V,22,272,141,0,435
Hall Gillsville,Gillsville,13,227,357,0,597
Hall Big Hickory,Big Hickory,93,1536,671,0,2300
Hall Friendship I,Friendship I,264,2904,1160,0,4328
Hall Friendship II,Friendship II,46,872,623,1,1542
Hall Friendship III,Friendship III,38,1195,529,0,1762
Hall Friendship IV,Friendship IV,46,1238,374,0,1658
Hancock Devereux Fire,Devereux Fire,19,231,130,0,380
Hancock St Mark,St Mark,6,22,22,0,50
Hancock Courthouse,Courthouse,4,60,43,0,107
Hancock Second Beulah,Second Beulah,3,17,16,0,36
Hancock Mayfield Community Center,Mayfield Community Center,3,11,9,0,23
Hancock Power of God,Power of God,4,48,25,0,77
Hancock Warren Chapel,Warren Chapel,9,68,41,0,118
Hancock Youth Center,Youth Center,14,57,29,0,100
Hancock Second Darrien,Second Darrien,0,22,59,0,81
Hancock Sparta 4C,Sparta 4C,0,6,11,0,17
Haralson Bremen,Bremen,131,1480,1392,0,3003
Haralson Buchanan,Buchanan,27,636,535,0,1198
Haralson Buncombe,Buncombe,8,171,298,0,477
Haralson Corinth,Corinth,32,307,496,0,835
Haralson Twentieth,Twentieth,4,147,267,0,418
Haralson Felton,Felton,5,53,138,0,196
Haralson Little Creek,Little Creek,18,96,303,0,417
Haralson Mt View,Mt View,5,47,150,0,202
Haralson Seventh,Seventh,24,384,492,0,900
Haralson Berea-Steadman,Berea-Steadman,17,100,239,0,356
Haralson Tallapoosa,Tallapoosa,43,540,657,0,1240
Haralson Waco,Waco,12,182,353,0,547
Harris Cataula,Cataula,38,669,704,2,1413
Harris Ellerslie,Ellerslie,91,873,993,0,1957
Harris Goodman,Goodman,22,345,325,0,692
Harris Hamilton,Hamilton,37,613,420,0,1070
Harris Lower 19th,Lower 19th,57,464,764,1,1286
Harris Mulberry Grove,Mulberry Grove,46,732,750,0,1528
Harris Pine Mountain Valley,Pine Mountain Valley,19,223,387,0,629
Harris Skinner,Skinner,11,64,299,0,374
Harris Upper 19th,Upper 19th,54,398,507,0,959
Harris Valley Plains,Valley Plains,4,90,216,0,310
Harris Waverly Hall,Waverly Hall,34,492,633,0,1159
Harris Whitesville,Whitesville,18,282,395,0,695
Hart Hartwell,Hartwell,85,1714,838,0,2637
Hart Goldmine,Goldmine,23,387,514,0,924
Hart Cokesbury,Cokesbury,10,187,199,0,396
Hart Reed Creek,Reed Creek,71,989,730,0,1790
Hart Bowersville,Bowersville,12,242,468,0,722
Hart Shoal Creek,Shoal Creek,25,394,479,0,898
Hart Bio,Bio,19,232,361,0,612
Heard Centralhatchee,Centralhatchee,57,397,569,0,1023
Heard Cooksville-Corinth,Cooksville-Corinth,8,99,187,0,294
Heard Enon Grove,Enon Grove,29,173,305,1,508
Heard Ephesus,Ephesus,41,208,449,0,698
Heard Franklin,Franklin,52,437,383,0,872
Heard Southwest,Southwest,16,82,180,0,278
Henry Locust Grove,Locust Grove,31,725,292,0,1048
Henry Tussahaw,Tussahaw,26,790,693,0,1509
Henry Sandy Ridge,Sandy Ridge,37,921,907,0,1865
Henry Westside,Westside,19,189,98,0,306
Henry Lowes,Lowes,45,855,360,0,1260
Henry South Hampton,South Hampton,23,825,333,0,1181
Henry North Hampton,North Hampton,33,880,316,0,1229
Henry Mount Carmel,Mount Carmel,18,362,159,0,539
Henry Red Oak,Red Oak,28,202,112,0,342
Henry Wesley Lakes,Wesley Lakes,24,397,143,1,565
Henry McDonough,McDonough,15,236,135,0,386
Henry McMullen,McMullen,22,672,662,0,1356
Henry East Lake,East Lake,36,899,425,1,1361
Henry Hickory Flat,Hickory Flat,27,588,198,0,813
Henry Stockbridge East-West,Stockbridge East-West,21,244,111,0,376
Henry Stagecoach,Stagecoach,14,408,181,0,603
Henry Cotton Indian,Cotton Indian,39,585,231,1,856
Henry Pleasant Grove,Pleasant Grove,60,745,321,1,1127
Henry Austin Road,Austin Road,18,337,156,0,511
Henry Swan Lake,Swan Lake,26,608,257,0,891
Henry Shakerag,Shakerag,7,145,69,0,221
Henry Ellenwood,Ellenwood,25,253,67,0,345
Henry Unity Grove,Unity Grove,37,1131,609,0,1777
Henry Shiloh,Shiloh,7,310,136,1,454
Henry Pates Creek,Pates Creek,62,623,288,3,976
Henry Oakland,Oakland,35,657,286,0,978
Henry Lake Dow,Lake Dow,52,930,598,0,1580
Henry Flippen,Flippen,40,396,131,0,567
Henry Stockbridge Central,Stockbridge Central,14,309,113,0,436
Henry Kelleytown,Kelleytown,23,671,519,1,1214
Henry Lighthouse,Lighthouse,38,395,208,0,641
Henry Dutchtown,Dutchtown,35,431,179,0,645
Henry Mt Bethel,Mt Bethel,20,397,891,0,1308
Henry Grove Park,Grove Park,19,664,298,0,981
Henry Lake Haven,Lake Haven,40,578,376,0,994
Henry McDonough Central,McDonough Central,56,638,165,0,859
Henry Timberridge,Timberridge,20,322,377,0,719
Houston ANNX,ANNX,98,1153,498,0,1749
Houston BMS,BMS,164,2431,1312,2,3909
Houston CENT,CENT,112,1256,892,0,2260
Houston CGTC,CGTC,71,1311,450,1,1833
Houston FMMS,FMMS,84,1514,984,1,2583
Houston HAFS,HAFS,17,386,604,0,1007
Houston HCTC,HCTC,70,783,393,0,1246
Houston HEFS,HEFS,25,284,356,0,665
Houston HHPC,HHPC,88,1303,523,1,1915
Houston MCMS,MCMS,65,2090,1156,3,3314
Houston NHSC,NHSC,41,517,292,0,850
Houston ROZR,ROZR,224,3553,1463,0,5240
Houston TMS,TMS,55,598,371,0,1024
Houston TWPK,TWPK,60,783,549,0,1392
Houston VHS,VHS,59,1592,966,3,2620
Houston WELL,WELL,49,364,219,0,632
Irwin Irwinville,Irwinville,29,440,485,0,954
Irwin Ocilla,Ocilla,21,802,455,1,1279
Irwin Holt,Holt,10,175,183,0,368
Jackson Central Jackson,Central Jackson,181,4734,2593,0,7508
Jackson North Jackson,North Jackson,182,3279,1965,3,5429
Jackson West Jackson,West Jackson,248,4836,2968,1,8053
Jackson South Jackson,South Jackson,110,1934,1344,1,3389
Jasper Wyatt,Wyatt,23,313,579,1,916
Jasper Monticello,Monticello,105,1201,541,5,1852
Jasper Martin & Burney,Martin & Burney,36,950,1197,0,2183
Jeff Davis Hazlehurst,Hazlehurst,8,165,130,0,303
Jeff Davis Altamaha 1,Altamaha 1,11,178,166,0,355
Jeff Davis Altamaha 2,Altamaha 2,13,320,437,0,770
Jeff Davis Blackburn 1,Blackburn 1,5,121,112,0,238
Jeff Davis Blackburn 2,Blackburn 2,7,168,235,0,410
Jeff Davis Whitehead 1,Whitehead 1,9,247,155,0,411
Jeff Davis Whitehead 2,Whitehead 2,2,114,237,1,354
Jeff Davis Ocmulgee 1,Ocmulgee 1,16,363,261,0,640
Jeff Davis Ocmulgee 2,Ocmulgee 2,3,116,138,0,257
Jefferson Stapleton Crossroads,Stapleton Crossroads,9,69,102,0,180
Jefferson Matthews,Matthews,7,43,219,0,269
Jefferson Wrens,Wrens,34,282,421,1,738
Jefferson Louisville,Louisville,40,645,255,0,940
Jefferson Wadley,Wadley,15,167,116,0,298
Jefferson Bartow,Bartow,7,59,91,0,157
Jefferson Stapleton,Stapleton,9,46,198,0,253
Jefferson Avera,Avera,2,28,176,0,206
Jenkins Primary School,Primary School,13,123,66,1,203
Jenkins Court House,Court House,14,134,69,0,217
Jenkins Perkins,Perkins,19,285,167,1,472
Jenkins Senior Citizens Center,Senior Citizens Center,25,302,201,0,528
Jenkins Four Points,Four Points,4,139,263,0,406
Johnson Wrightsville,Wrightsville,67,746,311,0,1124
Johnson Smith,Smith,13,149,273,0,435
Johnson Bray,Bray,17,191,187,0,395
Johnson Kite,Kite,10,186,334,0,530
Jones Gray,Gray,50,842,387,0,1279
Jones Hawkins,Hawkins,25,373,269,0,667
Jones Ethridge,Ethridge,35,378,243,0,656
Jones Clinton,Clinton,40,631,412,0,1083
Jones Roberts,Roberts,54,364,475,0,893
Jones Davidson,Davidson,15,353,402,0,770
Jones Pope,Pope,14,369,404,0,787
Jones Barron,Barron,18,269,340,0,627
Jones Sanders,Sanders,2,18,90,0,110
Jones Finney,Finney,45,501,671,0,1217
Lamar Barnesville,Barnesville,23,214,164,1,402
Lamar Chappell Mill V. FD,Chappell Mill V. FD,21,348,457,1,827
Lamar Senior Citzen Bldg,Senior Citzen Bldg,16,219,166,0,401
Lamar Redbone,Redbone,9,152,255,0,416
Lamar L C S C,L C S C,49,954,599,1,1603
Lamar Milner,Milner,36,884,845,2,1767
Lanier Lakeland,Lakeland,35,1106,719,0,1860
Laurens FBC-FLC,FBC-FLC,106,956,468,2,1532
Laurens Calhoun Park,Calhoun Park,40,320,234,0,594
Laurens Fire Dept Station 5,Fire Dept Station 5,79,940,737,0,1756
Laurens Buckeye,Buckeye,7,95,212,0,314
Laurens Burch,Burch,5,32,191,0,228
Laurens Cadwell,Cadwell,10,99,308,0,417
Laurens Brewton,Brewton,19,251,519,0,789
Laurens Dudley,Dudley,22,259,513,1,795
Laurens Hampton Mill,Hampton Mill,23,245,737,0,1005
Laurens Minter,Minter,20,142,392,5,559
Laurens Rural Fire Station 7,Rural Fire Station 7,32,369,608,1,1010
Laurens WT Adams Fire Station 18,WT Adams Fire Station 18,58,449,527,0,1034
Laurens Reedy Springs,Reedy Springs,6,77,386,0,469
Laurens Smith,Smith,35,316,483,0,834
Laurens LCFS #10,LCFS #10,28,306,403,0,737
Lee Chokee,Chokee,5,71,76,0,152
Lee Redbone,Redbone,36,1033,1080,1,2150
Lee Smithville ,Smithville ,5,152,161,0,318
Lee CJC,CJC,4,165,179,0,348
Lee Leesburg,Leesburg,23,677,485,0,1185
Lee Friendship Baptist,Friendship Baptist,6,314,360,0,680
Lee First Baptist,First Baptist,33,831,910,1,1775
Lee SDA Church,SDA Church,19,371,391,0,781
Lee Flint Reformed Baptist ,Flint Reformed Baptist ,14,499,451,0,964
Lee Century Fire Station,Century Fire Station,48,629,505,0,1182
Liberty Riceboro,Riceboro,10,70,50,0,130
Liberty Lyman Hall,Lyman Hall,17,208,118,0,343
Liberty Lewis Frasier,Lewis Frasier,26,211,132,0,369
Liberty Memorial Dr,Memorial Dr,3,100,74,0,177
Liberty Performing Arts CTR,Performing Arts CTR,6,151,113,0,270
Liberty Town of Allenhurst,Town of Allenhurst,5,85,80,0,170
Liberty Hinesville,Hinesville,29,352,197,0,578
Liberty Liberty County Complex,Liberty County Complex,47,900,434,0,1381
Liberty Victory Baptist,Victory Baptist,8,168,168,0,344
Liberty Fleming East,Fleming East,21,427,391,0,839
Liberty Gum Branch,Gum Branch,19,254,360,0,633
Liberty Progressive Church,Progressive Church,11,159,86,0,256
Lincoln Midway,Midway,4,148,142,0,294
Lincoln Lincoln Club House,Lincoln Club House,10,162,122,0,294
Lincoln Lincoln Center,Lincoln Center,17,385,256,0,658
Lincoln Faith Temple of Lincoln,Faith Temple of Lincoln,7,137,117,0,261
Lincoln Tabernacle,Tabernacle,12,209,201,0,422
Lincoln Bethany Church,Bethany Church,18,144,131,1,294
Lincoln Martins Crossroad,Martins Crossroad,26,293,305,0,624
Long Breads Creek,Breads Creek,10,186,326,0,522
Long Rye Patch_Oak Dale,Rye Patch_Oak Dale,11,295,300,1,607
Long South Ludowici,South Ludowici,6,211,188,0,405
Long North Ludowici,North Ludowici,10,262,186,0,458
Long Tibet,Tibet,10,218,202,0,430
Long Alma Flournoy,Alma Flournoy,0,29,26,0,55
Long Faith Baptist Annex,Faith Baptist Annex,6,173,103,0,282
Lowndes Train Depot,Train Depot,22,601,636,0,1259
Lowndes Historical Society ,Historical Society ,8,362,383,0,753
Lowndes Hahira Community Center ,Hahira Community Center ,9,244,280,2,535
Lowndes Pine Grove Church,Pine Grove Church,11,251,150,0,412
Lowndes Trinity Church,Trinity Church,21,495,312,4,832
Lowndes Nazarene Church,Nazarene Church,40,988,535,4,1567
Lowndes Mathis Auditorium ,Mathis Auditorium ,129,2633,916,6,3684
Lowndes Jaycee Community Center,Jaycee Community Center,11,112,49,0,172
Lowndes Lowndes Civic,Lowndes Civic,34,606,433,4,1077
Lowndes Naylor Community Center,Naylor Community Center,8,248,267,1,524
Lowndes Rainwater,Rainwater,123,3349,1493,8,4973
Lowndes VSU,VSU,0,0,4,0,4
Lowndes Mt. Calvary Church,Mt. Calvary Church,0,76,31,0,107
Lowndes Mildred Community Center,Mildred Community Center,2,13,14,1,30
Lowndes Paper Mill Union,Paper Mill Union,10,380,461,5,856
Lowndes Dasher City Hall,Dasher City Hall,16,470,572,1,1059
Lowndes Lake Park,Lake Park,22,549,752,7,1330
Lowndes South Lowndes Recreation Center,South Lowndes Recreation Center,27,488,517,7,1039
Lumpkin Dahlonega,Dahlonega,333,6280,3148,4,9765
Macon Ideal,Ideal,9,247,189,0,445
Macon Oglethorpe,Oglethorpe,8,196,87,0,291
Macon Marshallville,Marshallville,7,161,142,0,310
Macon Montezuma #4,Montezuma #4,8,192,68,0,268
Macon Montezuma #5,Montezuma #5,5,103,38,0,146
Madison Colbert,Colbert,42,703,631,1,1377
Madison Collins,Collins,14,137,216,0,367
Madison Comer,Comer,11,229,304,1,545
Madison Danielsville,Danielsville,55,1024,380,1,1460
Madison Fork,Fork,7,43,176,0,226
Madison Harrison,Harrison,10,91,270,1,372
Madison Hull,Hull,73,757,754,0,1584
Madison Ila,Ila,27,389,396,0,812
Madison Mill,Mill,40,475,402,0,917
Madison Paoli,Paoli,0,51,119,0,170
Madison Pittman,Pittman,52,426,471,3,952
Madison Poca,Poca,10,246,314,1,571
Marion Pineknot,Pineknot,7,136,314,0,457
Marion Buena Vista,Buena Vista,25,356,161,0,542
Marion Tazewell,Tazewell,4,52,132,0,188
Marion Brantley,Brantley,5,105,121,0,231
Marion Fort Perry,Fort Perry,13,97,222,0,332
McDuffie NMcDuffie,NMcDuffie,26,597,270,0,893
McDuffie Cedar Rock,Cedar Rock,78,804,331,0,1213
McDuffie Depot,Depot,9,88,45,0,142
McDuffie Sweetwater,Sweetwater,19,302,152,0,473
McDuffie White Oak,White Oak,48,703,285,0,1036
McDuffie Dearing,Dearing,29,465,335,0,829
McDuffie Fort Creek,Fort Creek,10,276,195,0,481
McIntosh Sapelo Island,Sapelo Island,0,4,4,0,8
McIntosh Crescent,Crescent,6,269,143,0,418
McIntosh Darien,Darien,48,519,238,0,805
McIntosh South Newport,South Newport,53,692,522,0,1267
McIntosh North Darien,North Darien,47,520,279,0,846
Meriwether Chalybeate,Chalybeate,4,53,178,0,235
Meriwether Gill I,Gill I,23,197,317,0,537
Meriwether Gill II,Gill II,2,54,52,0,108
Meriwether 7th-Odessadale,7th-Odessadale,1,61,66,0,128
Meriwether 8th-Greenville,8th-Greenville,17,325,215,0,557
Meriwether Lone Oak,Lone Oak,8,184,259,0,451
Meriwether Luthersville,Luthersville,32,431,489,0,952
Meriwether Upper 9th-Alvaton,Upper 9th-Alvaton,17,235,398,0,650
Meriwether Middle 9th-Gay,Middle 9th-Gay,5,60,128,0,193
Meriwether Lower 9th-Woodbury,Lower 9th-Woodbury,16,192,202,1,411
Meriwether 2nd-Warm Springs,2nd-Warm Springs,24,164,254,0,442
Meriwether Third-Durand,Third-Durand,9,104,172,0,285
Meriwether Raleigh,Raleigh,9,116,129,0,254
Meriwether Cove,Cove,4,33,96,0,133
Miller Colquitt-Miller,Colquitt-Miller,80,878,659,0,1617
Mitchell Baconton,Baconton,6,108,211,0,325
Mitchell Branchville,Branchville,8,93,237,1,339
Mitchell Camilla North,Camilla North,6,140,54,0,200
Mitchell Camilla South,Camilla South,71,690,248,0,1009
Mitchell Cotton,Cotton,8,51,184,0,243
Mitchell Hopeful,Hopeful,4,50,123,0,177
Mitchell Hinsonton,Hinsonton,1,5,78,0,84
Mitchell Lester,Lester,25,186,337,0,548
Mitchell Pebble City,Pebble City,4,20,69,0,93
Mitchell Pelham,Pelham,29,398,372,1,800
Mitchell Sale City,Sale City,6,22,140,0,168
Monroe Bentons,Bentons,32,661,551,1,1245
Monroe Brantleys,Brantleys,6,394,268,0,668
Monroe Burgays,Burgays,47,666,689,1,1403
Monroe Cabaniss,Cabaniss,5,123,212,0,340
Monroe Cox,Cox,6,200,204,0,410
Monroe Culloden,Culloden,5,71,128,0,204
Monroe Dillards,Dillards,8,271,244,1,524
Monroe Evers,Evers,19,659,442,1,1121
Monroe Forsyth,Forsyth,44,759,335,0,1138
Monroe High Falls,High Falls,11,396,465,0,872
Monroe Kelseys,Kelseys,3,95,155,0,253
Monroe Middlebrooks,Middlebrooks,10,404,275,0,689
Monroe Proctors,Proctors,4,224,309,0,537
Monroe Russellville,Russellville,1,91,177,0,269
Montgomery Ailey,Ailey,5,125,86,0,216
Montgomery Alston,Alston,2,83,185,0,270
Montgomery Higgston,Higgston,13,273,356,0,642
Montgomery Kibbee,Kibbee,6,71,230,0,307
Montgomery Mount Vernon,Mount Vernon,18,252,169,0,439
Montgomery Tarrytown,Tarrytown,2,48,149,0,199
Montgomery Uvalda,Uvalda,12,122,243,0,377
Morgan Rec Dept,Rec Dept,19,485,153,0,657
Morgan Centennial,Centennial,33,843,774,0,1650
Morgan Gibbs,Gibbs,49,826,762,1,1638
Morgan DFACS,DFACS,44,1105,500,5,1654
Morgan Buckhead,Buckhead,41,903,778,1,1723
Murray McDonald,McDonald,16,563,505,0,1084
Murray Shuck Pen,Shuck Pen,11,448,799,0,1258
Murray Southwest,Southwest,4,453,816,0,1273
Murray Spring Place,Spring Place,20,713,799,0,1532
Murray Town,Town,77,1499,1086,0,2662
Murray Carters-Doolittle,Carters-Doolittle,18,331,577,0,926
Murray North,North,20,350,632,0,1002
Muscogee Wynnton,Wynnton,27,261,211,0,499
Muscogee Carver/Library,Carver/Library,1,34,23,0,58
Muscogee Shirley Winston,Shirley Winston,18,71,44,0,133
Muscogee Britt David,Britt David,32,248,432,0,712
Muscogee St Peter,St Peter,47,416,595,0,1058
Muscogee Chattahoochee,Chattahoochee,96,933,933,0,1962
Muscogee Columbus Tech,Columbus Tech,23,376,297,0,696
Muscogee Central,Central,85,1425,1051,0,2561
Muscogee Wynnbrook,Wynnbrook,105,703,417,0,1225
Muscogee Cusseta Rd,Cusseta Rd,5,39,40,1,85
Muscogee OLOLC,OLOLC,32,141,208,0,381
Muscogee Mt Pilgrim,Mt Pilgrim,13,64,58,0,135
Muscogee Faith Tabernacle,Faith Tabernacle,7,67,57,0,131
Muscogee Canaan,Canaan,61,200,129,0,390
Muscogee Holsey,Holsey,30,196,94,0,320
Muscogee Gentian,Gentian,82,642,491,0,1215
Muscogee St Paul,St Paul,96,977,615,0,1688
Muscogee Moon,Moon,78,698,656,0,1432
Muscogee St Andrews,St Andrews,111,1104,1021,0,2236
Muscogee Salvation Army,Salvation Army,29,298,336,0,663
Muscogee First African,First African,9,73,88,0,170
Muscogee Epworth,Epworth,42,363,457,0,862
Muscogee Gallops,Gallops,14,128,95,0,237
Muscogee Edgewood,Edgewood,24,174,233,0,431
Muscogee Psalmond,Psalmond,104,1147,965,0,2216
Newton 01-City Pond,01-City Pond,12,98,149,0,259
Newton 02-Town,02-Town,28,236,139,0,403
Newton 03-Almon,03-Almon,27,224,240,0,491
Newton 04-Alcovy,04-Alcovy,88,641,622,0,1351
Newton 05-Covington Mills,05-Covington Mills,40,331,318,0,689
Newton 06-Brewers,06-Brewers,49,399,951,1,1400
Newton 07-Brick Store,07-Brick Store,52,407,732,1,1192
Newton 08-Cedar Shoals,08-Cedar Shoals,23,201,256,0,480
Newton 09-Livingston,09-Livingston,14,254,226,0,494
Newton 10-Downs,10-Downs,40,827,487,0,1354
Newton 12-Gum Creek,12-Gum Creek,119,860,776,0,1755
Newton 13-Beaverdam,13-Beaverdam,31,258,174,1,464
Newton 14-Leguinn,14-Leguinn,28,313,608,0,949
Newton 15-Mansfield,15-Mansfield,30,173,709,0,912
Newton 16-Newborn,16-Newborn,6,65,347,0,418
Newton 17-Oxford,17-Oxford,39,339,523,0,901
Newton 18-Rocky Plains,18-Rocky Plains,25,359,541,0,925
Newton 19-Buck Creek,19-Buck Creek,27,544,362,0,933
Newton 20-Stansells,20-Stansells,30,265,217,0,512
Newton 23-Fairview,23-Fairview,13,87,57,0,157
Newton 24-Crowell,24-Crowell,13,121,90,0,224
Newton 25-Hub,25-Hub,64,435,815,0,1314
Oconee City Hall,City Hall,48,1160,431,0,1639
Oconee Colham Ferry,Colham Ferry,41,1282,435,0,1758
Oconee Bishop,Bishop,27,851,458,0,1336
Oconee North Oconee,North Oconee,47,1074,523,1,1645
Oconee Dark Corner,Dark Corner,43,1328,800,0,2171
Oconee Bogart,Bogart,30,598,448,0,1076
Oconee Marswood Hall,Marswood Hall,108,1217,561,0,1886
Oconee Civic Center,Civic Center,164,2305,701,0,3170
Oglethorpe Beaverdam,Beaverdam,58,737,695,0,1490
Oglethorpe Crawford,Crawford,59,724,443,0,1226
Oglethorpe Lexington,Lexington,111,1257,554,0,1922
Paulding Burnt Hickory Park,Burnt Hickory Park,100,2050,1161,1,3312
Paulding Crossroads Library,Crossroads Library,57,1047,673,0,1777
Paulding Shelton Elementary,Shelton Elementary,64,1066,856,0,1986
Paulding Russom Elementary,Russom Elementary,234,2424,1709,0,4367
Paulding Paulding Sr Center,Paulding Sr Center,51,1206,826,2,2085
Paulding Legacy Bapt Church,Legacy Bapt Church,102,862,409,1,1374
Paulding Watson Govt Cmplx,Watson Govt Cmplx,144,1963,750,3,2860
Paulding East Paulding Middle Sch,East Paulding Middle Sch,195,3087,1642,1,4925
Paulding Events Place,Events Place,48,544,306,1,899
Paulding Poplar Sprgs Bapt Church,Poplar Sprgs Bapt Church,46,643,334,2,1025
Paulding D Wright Innovation Ctr,D Wright Innovation Ctr,58,1386,609,1,2054
Paulding Taylor Farm Park,Taylor Farm Park,39,596,244,0,879
Paulding Nebo Elem School,Nebo Elem School,117,2117,1410,1,3645
Paulding White Oak Park,White Oak Park,61,1068,670,4,1803
Paulding Mulberry Rock Park,Mulberry Rock Park,115,1591,1167,2,2875
Paulding Beulahland Baptist Church,Beulahland Baptist Church,35,536,502,1,1074
Paulding Paulding County Airport,Paulding County Airport,75,853,823,6,1757
Paulding Dobbins Middle School,Dobbins Middle School,72,1336,583,1,1992
Peach Byron #1,Byron #1,18,812,317,0,1147
Peach Byron #2,Byron #2,49,1273,460,3,1785
Peach Claude,Claude,8,240,224,0,472
Peach Fort Valley #1,Fort Valley #1,32,291,180,0,503
Peach Fort Valley #2,Fort Valley #2,5,284,140,4,433
Peach Fort Valley #3,Fort Valley #3,3,165,56,0,224
Peach Powersville,Powersville,15,304,273,0,592
Pickens Yellow Creek,Yellow Creek,64,1082,696,0,1842
Pickens Sharptop,Sharptop,56,836,555,1,1448
Pickens Appalachian,Appalachian,27,590,311,0,928
Pickens Refuge,Refuge,34,737,413,0,1184
Pickens Hill City,Hill City,29,596,450,0,1075
Pickens Hinton,Hinton,10,133,325,0,468
Pickens Jerusalem,Jerusalem,7,162,475,0,644
Pickens Ludville,Ludville,3,101,259,0,363
Pickens Nelson,Nelson,10,298,384,0,692
Pickens Talking Rock,Talking Rock,12,503,441,1,957
Pickens Jasper,Jasper,36,702,368,0,1106
Pickens Tate,Tate,42,715,586,0,1343
Pierce Hacklebarney/Cason ,Hacklebarney/Cason ,42,927,410,0,1379
Pierce Blackshear,Blackshear,36,1075,472,0,1583
Pierce St. Johns/Blackshear,St. Johns/Blackshear,24,459,226,0,709
Pierce Otter Creek,Otter Creek,33,466,375,0,874
Pierce Patterson,Patterson,15,303,232,0,550
Pierce Mershon,Mershon,5,203,72,0,280
Pierce Alabaha,Alabaha,16,398,158,0,572
Pierce Sunset/Sweat,Sunset/Sweat,14,256,108,0,378
Pike Concord,Concord,16,354,416,0,786
Pike Hollonville,Hollonville,33,601,515,0,1149
Pike Meansville,Meansville,17,365,379,0,761
Pike Molena,Molena,10,406,434,0,850
Pike Second District,Second District,42,977,541,0,1560
Pike Lifsey Springs,Lifsey Springs,21,331,314,1,667
Pike Williamson,Williamson,21,618,466,0,1105
Pike Zebulon,Zebulon,34,703,333,0,1070
Polk Aragon,Aragon,24,857,602,5,1488
Polk Blooming Grove,Blooming Grove,24,370,357,4,755
Polk Cedartown,Cedartown,92,1340,550,0,1982
Polk Fish Creek,Fish Creek,20,734,547,5,1306
Polk Lake Creek,Lake Creek,29,916,551,1,1497
Polk Rockmart,Rockmart,58,1530,780,6,2374
Polk Youngs Grove,Youngs Grove,26,541,450,7,1024
Pulaski Annex,Annex,102,1562,655,0,2319
Putnam 101,101,45,616,306,1,968
Putnam 104,104,61,642,336,0,1039
Putnam 105,105,93,1401,735,0,2229
Putnam 106,106,20,393,365,0,778
Putnam 107,107,109,1246,794,1,2150
Quitman Georgetown,Georgetown,19,298,167,0,484
Quitman Morris,Morris,1,7,19,0,27
Rabun Rabun County,Rabun County,416,4368,1396,0,6180
Randolph Coleman,Coleman,4,40,50,0,94
Randolph Shellman,Shellman,10,101,171,1,283
Randolph Benevolence,Benevolence,3,53,59,0,115
Randolph Cuthbert-Courthouse,Cuthbert-Courthouse,13,417,184,0,614
Randolph Cuthbert,Cuthbert,1,3,0,0,4
Randolph Springvale,Springvale,6,14,28,0,48
Richmond 101,101,11,96,229,0,336
Richmond 102,102,5,47,57,0,109
Richmond 103,103,0,10,7,0,17
Richmond 104,104,8,35,37,0,80
Richmond 105,105,0,8,4,0,12
Richmond 106,106,4,25,57,0,86
Richmond 107,107,19,161,265,0,445
Richmond 108,108,3,8,21,0,32
Richmond 109,109,3,5,5,0,13
Richmond 110,110,0,4,11,0,15
Richmond 111,111,8,46,75,0,129
Richmond 112,112,30,77,63,0,170
Richmond 115,115,4,15,56,0,75
Richmond 201,201,10,77,133,0,220
Richmond 202,202,27,160,295,0,482
Richmond 203,203,0,5,7,0,12
Richmond 204,204,9,111,237,1,358
Richmond 207,207,9,28,34,0,71
Richmond 208,208,5,54,95,0,154
Richmond 210,210,7,34,53,0,94
Richmond 301,301,36,275,400,0,711
Richmond 302,302,11,47,42,0,100
Richmond 303,303,30,329,330,0,689
Richmond 304,304,9,127,131,0,267
Richmond 306,306,56,244,264,0,564
Richmond 307,307,30,233,312,0,575
Richmond 308,308,6,47,52,0,105
Richmond 310,310,29,199,300,0,528
Richmond 401,401,3,20,8,0,31
Richmond 402,402,4,38,40,0,82
Richmond 403,403,5,64,71,0,140
Richmond 405,405,9,115,98,0,222
Richmond 406,406,7,59,61,0,127
Richmond 501,501,11,62,65,0,138
Richmond 502,502,6,46,60,0,112
Richmond 503,503,10,90,69,0,169
Richmond 504,504,34,242,482,0,758
Richmond 505,505,3,52,19,0,74
Richmond 506,506,21,67,124,0,212
Richmond 507,507,2,37,48,0,87
Richmond 601,601,14,148,225,1,388
Richmond 602,602,2,7,27,0,36
Richmond 604,604,2,45,159,0,206
Richmond 605,605,26,203,305,0,534
Richmond 606,606,7,42,32,0,81
Richmond 607,607,8,30,58,0,96
Richmond 608,608,1,19,47,0,67
Richmond 701,701,35,404,484,0,923
Richmond 702,702,18,188,305,0,511
Richmond 703,703,29,271,391,0,691
Richmond 704,704,19,112,104,0,235
Richmond 705,705,37,339,358,0,734
Richmond 706,706,47,782,433,0,1262
Richmond 707,707,13,230,246,0,489
Richmond 708,708,5,34,87,0,126
Richmond 709,709,11,79,66,0,156
Richmond 801,801,4,8,66,0,78
Richmond 801B,801B,6,16,171,0,193
Richmond 802,802,20,219,743,0,982
Richmond 803,803,0,1,9,0,10
Richmond 804,804,12,140,238,0,390
Richmond 804H,804H,32,225,473,0,730
Richmond 805,805,6,34,89,1,130
Richmond 806,806,16,211,554,0,781
Richmond 807,807,6,62,99,0,167
Richmond 808,808,19,187,412,0,618
Richmond 810,810,2,55,100,0,157
Richmond 811,811,3,20,96,0,119
Rockdale BA,BA,41,477,317,1,836
Rockdale BT,BT,44,556,598,0,1198
Rockdale CO,CO,17,170,107,0,294
Rockdale FI,FI,17,243,87,0,347
Rockdale FS,FS,20,257,102,0,379
Rockdale HC,HC,16,290,201,0,507
Rockdale HI,HI,21,317,224,1,563
Rockdale LA,LA,10,123,88,0,221
Rockdale LO,LO,35,368,453,0,856
Rockdale MA,MA,26,309,327,0,662
Rockdale MI,MI,18,216,115,1,350
Rockdale OT,OT,21,199,84,1,305
Rockdale RO,RO,28,396,170,0,594
Rockdale SM,SM,20,308,176,2,506
Rockdale SP,SP,41,328,131,0,500
Rockdale ST,ST,51,414,138,1,604
Schley Precinct One,Precinct One,44,922,501,0,1467
Screven Sylvania,Sylvania,25,202,112,0,339
Screven Hunters,Hunters,3,67,106,0,176
Screven Newington,Newington,2,135,273,0,410
Screven Jenk Hill Fire Sta,Jenk Hill Fire Sta,7,183,137,0,327
Screven Rocky Ford,Rocky Ford,2,101,140,0,243
Screven Bay Branch,Bay Branch,10,253,232,0,495
Screven Hiltonia,Hiltonia,2,144,124,0,270
Screven Screven Rec Dept,Screven Rec Dept,6,55,47,0,108
Screven Greenhill Church,Greenhill Church,8,215,190,0,413
Screven Sr Citizens Center,Sr Citizens Center,5,170,56,0,231
Screven Jackson Fire Station,Jackson Fire Station,3,62,89,0,154
Screven Cooperville Fire Station,Cooperville Fire Station,0,12,25,0,37
Seminole Precinct 1,Precinct 1,20,225,295,0,540
Seminole Precinct 2,Precinct 2,16,197,174,0,387
Seminole Precinct 3,Precinct 3,0,29,40,0,69
Seminole Precinct 4,Precinct 4,12,174,298,1,485
Seminole Precinct 5,Precinct 5,15,206,450,0,671
Spalding 01,01,2,25,35,0,62
Spalding 02,02,6,32,24,0,62
Spalding 03,03,48,829,379,0,1256
Spalding 05,05,26,337,214,2,579
Spalding 06,06,13,120,58,0,191
Spalding 07,07,30,410,308,0,748
Spalding 08,08,26,446,287,0,759
Spalding 09,09,34,368,434,0,836
Spalding 10,10,19,394,307,0,720
Spalding 11,11,32,531,425,0,988
Spalding 12,12,39,464,504,0,1007
Spalding 13,13,35,439,611,2,1087
Spalding 14,14,11,202,378,0,591
Spalding 16,16,43,291,219,1,554
Spalding 17,17,14,254,252,0,520
Spalding 19,19,48,524,457,0,1029
Spalding 20,20,22,466,498,1,987
Spalding 21,21,120,1382,488,0,1990
Stephens Senior Center,Senior Center,324,5177,1873,0,7374
Stewart Richland,Richland,14,118,124,3,259
Stewart Louvale,Louvale,2,18,50,1,71
Stewart Lumpkin,Lumpkin,18,175,61,1,255
Stewart Omaha,Omaha,1,9,42,1,53
Sumter Agri-Center,Agri-Center,24,451,205,0,680
Sumter Airport,Airport,21,364,206,2,593
Sumter Andersonville,Andersonville,5,39,162,0,206
Sumter Browns Mill,Browns Mill,9,185,223,0,417
Sumter Concord,Concord,3,67,153,0,223
Sumter JROTC,JROTC,44,519,259,0,822
Sumter Leslie,Leslie,14,307,360,0,681
Sumter Plains,Plains,13,120,195,1,329
Sumter Rec Dept,Rec Dept,16,141,67,0,224
Sumter Rees Park,Rees Park,16,156,59,1,232
Sumter Thompson,Thompson,15,71,97,0,183
Talbot ONeal,ONeal,5,61,91,0,157
Talbot Valley,Valley,9,95,126,0,230
Talbot Junction City,Junction City,3,49,47,0,99
Talbot Geneva,Geneva,9,47,73,0,129
Talbot Talbotton,Talbotton,4,50,36,0,90
Talbot Box Springs,Box Springs,4,25,134,0,163
Talbot Flint Hill,Flint Hill,5,118,127,0,250
Taliaferro Sharon,Sharon,4,27,43,0,74
Taliaferro Crawfordville,Crawfordville,10,135,91,0,236
Tattnall Cobbtown,Cobbtown,12,113,211,0,336
Tattnall Collins,Collins,18,333,293,0,644
Tattnall District II,District II,11,522,236,1,770
Tattnall District IV,District IV,31,626,392,0,1049
Tattnall District V,District V,11,223,314,0,548
Tattnall East Glennville,East Glennville,49,623,412,0,1084
Tattnall Manassas,Manassas,5,68,102,0,175
Tattnall Shiloh,Shiloh,5,162,93,0,260
Taylor Precinct 1,Precinct 1,4,58,38,0,100
Taylor Precinct 5,Precinct 5,39,766,339,6,1150
Taylor Precinct 6,Precinct 6,27,461,282,0,770
Telfair Helena,Helena,11,188,149,0,348
Telfair Jacksonville,Jacksonville,20,113,175,0,308
Telfair Lumber-City,Lumber-City,8,117,187,0,312
Telfair McRae,McRae,41,461,234,0,736
Telfair Milan,Milan,22,190,261,0,473
Telfair Scotland,Scotland,0,49,114,0,163
Terrell Dawson ,Dawson ,29,201,103,0,333
Terrell Sasser,Sasser,17,255,298,0,570
Terrell Bronwood,Bronwood,11,113,138,0,262
Terrell Parrott,Parrott,5,46,133,0,184
Terrell Graves,Graves,14,88,139,0,241
Terrell Herod-Dover,Herod-Dover,1,29,75,0,105
Thomas Barwick,Barwick,7,158,159,0,324
Thomas Boston,Boston,10,259,196,0,465
Thomas Central,Central,38,936,420,0,1394
Thomas Coolidge,Coolidge,4,160,274,1,439
Thomas Douglass,Douglass,5,128,47,0,180
Thomas Little Ochlocknee Baptist,Little Ochlocknee Baptist,14,307,285,1,607
Thomas Fire Station #2,Fire Station #2,28,492,189,0,709
Thomas Gatlin Creek,Gatlin Creek,17,564,338,0,919
Thomas Harper,Harper,4,173,63,0,240
Thomas Jerger,Jerger,37,548,157,0,742
Thomas Meigs,Meigs,5,116,147,1,269
Thomas Merrillville,Merrillville,9,189,110,0,308
Thomas Metcalfe,Metcalfe,2,50,89,0,141
Thomas New Covenant,New Covenant,26,608,295,1,930
Thomas Ochlocknee,Ochlocknee,5,247,316,0,568
Thomas Pavo,Pavo,3,109,93,0,205
Thomas Patten,Patten,5,108,228,0,341
Thomas Remington Esc,Remington Esc,27,475,233,1,736
Thomas Resource Center,Resource Center,3,40,16,0,59
Thomas Scott,Scott,31,659,215,0,905
Tift Tifton NE,Tifton NE,30,676,269,3,978
Tift Brighton,Brighton,24,791,483,1,1299
Tift Brookfield ,Brookfield ,8,351,356,0,715
Tift Chula,Chula,14,342,416,0,772
Tift Docia,Docia,9,326,311,0,646
Tift Eldorado,Eldorado,10,314,365,1,690
Tift Omega,Omega,1,85,241,0,327
Tift TY TY,TY TY,12,244,277,0,533
Tift Tifton NW,Tifton NW,36,907,415,0,1358
Tift Tifton South,Tifton South,9,227,77,0,313
Tift Mott-Litman Gym,Mott-Litman Gym,5,136,54,0,195
Tift Tifton Lodge ,Tifton Lodge ,28,730,337,0,1095
Toombs 15361 Lyons,15361 Lyons,53,829,416,0,1298
Toombs 39 Newbranch,39 Newbranch,21,388,398,1,808
Toombs 43 Cedar Crossing,43 Cedar Crossing,23,301,430,0,754
Toombs 513 VPD,513 VPD,96,1423,664,1,2184
Toombs 514 STIALC,514 STIALC,58,799,397,0,1254
Towns Young Harris,Young Harris,75,967,608,2,1652
Towns Hiawassee,Hiawassee,200,2784,931,1,3916
Treutlen Annex,Annex,28,670,380,2,1080
Treutlen Soperton,Soperton,30,347,264,0,641
Troup Hollis Hand,Hollis Hand,94,919,627,2,1642
Troup Administration Bldg,Administration Bldg,27,205,163,0,395
Troup Hammett Rd,Hammett Rd,46,321,307,0,674
Troup Griggs Center,Griggs Center,2,37,27,0,66
Troup West Point,West Point,12,69,229,0,310
Troup Hogansville,Hogansville,31,541,825,0,1397
Troup East Vernon,East Vernon,55,727,798,2,1582
Troup Rosemont,Rosemont,65,1050,943,2,2060
Troup McClendon,McClendon,42,771,816,0,1629
Troup Long Cane,Long Cane,31,526,813,1,1371
Troup Gardner Newman,Gardner Newman,32,471,383,1,887
Troup Gray Hill,Gray Hill,13,231,517,2,763
Troup Highland,Highland,18,204,150,0,372
Troup Northside,Northside,40,477,272,0,789
Turner Ashburn,Ashburn,10,257,122,0,389
Turner Sycamore,Sycamore,15,631,287,2,935
Turner Rebecca,Rebecca,5,343,219,1,568
Twiggs Dry Branch,Dry Branch,13,179,371,0,563
Twiggs Golden Isles,Golden Isles,10,152,216,0,378
Twiggs Higgsville,Higgsville,11,133,199,0,343
Twiggs Jeffersonville-Ware,Jeffersonville-Ware,10,175,147,0,332
Twiggs Shady Grove-Tarvers,Shady Grove-Tarvers,7,127,136,0,270
Union Blairsville,Blairsville,50,780,360,0,1190
Union Coosa,Coosa,43,773,530,0,1346
Union Choestoe,Choestoe,50,392,403,0,845
Union Jones Creek,Jones Creek,34,580,557,1,1172
Union Owltown,Owltown,33,494,313,0,840
Union Ivy Log,Ivy Log,46,702,529,1,1278
Union Suches,Suches,12,71,256,0,339
Union Trackrock,Trackrock,22,366,243,0,631
Union Dooley,Dooley,16,457,446,0,919
Union Gumlog,Gumlog,35,718,494,1,1248
Union Pat Colwell,Pat Colwell,69,837,472,0,1378
Upson Yatesville,Yatesville,8,248,436,0,692
Upson Salem,Salem,1,16,19,1,37
Upson Redbone,Redbone,137,2441,1087,0,3665
Upson Town,Town,102,1534,655,0,2291
Walker La Fayette,La Fayette,95,1240,1044,3,2382
Walker Walnut Grove,Walnut Grove,29,440,559,0,1028
Walker Rock Spring,Rock Spring,85,1711,1140,1,2937
Walker Armuchee Valley,Armuchee Valley,9,126,577,2,714
Walker Mountain,Mountain,14,124,411,1,550
Walker Chattanooga Valley,Chattanooga Valley,113,1207,1188,2,2510
Walker Kensington,Kensington,11,149,416,0,576
Walker Rossville,Rossville,68,988,734,0,1790
Walker Chickamauga,Chickamauga,81,1801,1197,0,3079
Walker Fairyland,Fairyland,17,223,287,0,527
Walker Fairview,Fairview,40,422,507,2,971
Walton Bold Springs,Bold Springs,68,1189,1216,1,2474
Walton Whatley,Whatley,32,484,375,0,891
Walton Walker Park,Walker Park,78,1024,878,0,1980
Walton Gratis,Gratis,27,353,438,0,818
Walton Between,Between,54,1450,1091,0,2595
Walton Walnut Grove,Walnut Grove,22,595,604,0,1221
Walton Loganvile North,Loganvile North,76,1061,640,0,1777
Walton Social Circle,Social Circle,47,1183,745,0,1975
Walton South Monroe,South Monroe,59,955,466,0,1480
Walton North Monroe,North Monroe,32,489,445,0,966
Walton Loganville South,Loganville South,49,780,467,0,1296
Walton West Walton,West Walton,49,1099,801,1,1950
Walton Broken Arrow,Broken Arrow,63,1023,822,0,1908
Walton Bay Creek,Bay Creek,54,963,576,1,1594
Walton E Monroe,E Monroe,41,582,515,0,1138
Walton W Monroe,W Monroe,27,661,427,2,1117
Walton Tara,Tara,34,783,406,0,1223
Walton Mountain,Mountain,41,374,494,0,909
Walton Jersey,Jersey,24,476,676,0,1176
Walton Blasingame,Blasingame,15,255,427,1,698
Walton Good Hope,Good Hope,32,512,823,0,1367
Ware 100 - City Auditorium,100 - City Auditorium,30,269,122,1,422
Ware 200A - Memorial Stadium,200A - Memorial Stadium,86,1096,330,0,1512
Ware 200B - City Auditorium,200B - City Auditorium,32,238,65,0,335
Ware 300 - Ware BoE Transportation,300 - Ware BoE Transportation,96,851,507,1,1455
Ware 304 - Ware BoE Learning Center,304 - Ware BoE Learning Center,15,184,180,0,379
Ware 400 - Second Baptist Church,400 - Second Baptist Church,8,223,592,0,823
Ware 404 - Bickley UM Church,404 - Bickley UM Church,6,64,170,1,241
Ware 405 - Haywood Baptist Church,405 - Haywood Baptist Church,6,111,242,0,359
Ware 406 - Jamestown Baptist Church,406 - Jamestown Baptist Church,23,380,419,0,822
Ware 407 - Manor Commmunity Center,407 - Manor Commmunity Center,12,98,247,0,357
Ware 408 - Millwood Baptist Church,408 - Millwood Baptist Church,2,56,226,1,285
Ware 409 - Waresboro Church of God,409 - Waresboro Church of God,15,252,310,0,577
Warren Warrenton,Warrenton,63,626,318,0,1007
Washington Riddleville,Riddleville,7,88,149,0,244
Washington Warthen,Warthen,7,94,170,0,271
Washington Tennille,Tennille,26,333,250,1,610
Washington Oconee,Oconee,9,57,139,0,205
Washington Harrison,Harrison,14,167,232,1,414
Washington Davisboro,Davisboro,16,115,177,0,308
Washington Sandersville,Sandersville,89,1020,475,0,1584
Washington Deepstep,Deepstep,7,63,198,0,268
Wayne Odum,Odum,15,295,468,1,779
Wayne Madray Springs,Madray Springs,22,348,325,0,695
Wayne Oglethorpe,Oglethorpe,28,484,379,0,891
Wayne Screven,Screven,21,378,571,0,970
Wayne Empire,Empire,21,280,298,0,599
Wayne Red Hill,Red Hill,12,212,183,0,407
Wayne Altamaha,Altamaha,41,669,316,0,1026
Wayne Gardi,Gardi,24,222,352,0,598
Wayne VFW,VFW,6,54,43,0,103
Wayne Pine Street,Pine Street,14,217,113,0,344
Wayne Unity,Unity,44,389,276,0,709
Wayne Rec Center,Rec Center,28,324,365,0,717
Webster Preston 1,Preston 1,60,411,205,0,676
Wheeler Alamo,Alamo,31,403,315,2,751
Wheeler Glenwood,Glenwood,16,229,270,0,515
White Blue Creek,Blue Creek,52,631,506,0,1189
White Blue Ridge,Blue Ridge,20,284,233,0,537
White Robertstown-Helen,Robertstown-Helen,15,213,216,0,444
White Mossy Creek,Mossy Creek,56,821,790,1,1668
White Mt Yonah,Mt Yonah,93,1298,714,1,2106
White Nacoochee,Nacoochee,37,425,260,0,722
White Shoal Creek,Shoal Creek,35,579,589,0,1203
White Tesnatee,Tesnatee,24,360,232,0,616
White Town Creek,Town Creek,29,398,383,0,810
White White Creek,White Creek,47,470,437,0,954
Whitefield 1A,1A,34,196,165,0,395
Whitefield 2A,2A,32,602,493,1,1128
Whitefield 3A,3A,20,363,390,0,773
Whitefield 4A,4A,21,464,425,1,911
Whitefield 5A,5A,3,48,133,0,184
Whitefield 6A,6A,5,63,76,0,144
Whitefield AN,AN,11,143,254,0,408
Whitefield CA,CA,17,187,515,1,720
Whitefield CO,CO,9,148,510,2,669
Whitefield DG,DG,44,431,709,1,1185
Whitefield ES,ES,11,166,283,0,460
Whitefield FI,FI,25,210,477,0,712
Whitefield GL,GL,26,332,468,1,827
Whitefield LT,LT,21,228,384,1,634
Whitefield MC,MC,13,249,584,1,847
Whitefield NI,NI,18,320,763,1,1102
Whitefield PG,PG,71,747,924,0,1742
Whitefield TH,TH,39,532,978,2,1551
Whitefield TI,TI,1,54,235,1,291
Whitefield TR,TR,22,250,493,0,765
Whitefield UT,UT,7,128,393,0,528
Whitefield VA,VA,58,801,1352,4,2215
Whitefield WS,WS,36,478,681,1,1196
Wilcox Rochelle North #1,Rochelle North #1,3,26,32,0,61
Wilcox Abbeville North #2,Abbeville North #2,3,73,53,0,129
Wilcox Pineview #2,Pineview #2,9,63,150,0,222
Wilcox Pitts #3,Pitts #3,8,146,307,0,461
Wilcox Rochelle South #4,Rochelle South #4,16,233,299,0,548
Wilcox Abbeville South #5,Abbeville South #5,32,316,178,0,526
Wilkes Senior Citizen Center,Senior Citizen Center,15,192,110,0,317
Wilkes Young Famer's Bldg,Young Famer's Bldg,21,333,261,0,615
Wilkes Metasville Fire Sta,Metasville Fire Sta,10,125,175,0,310
Wilkes Edward B Pope Center,Edward B Pope Center,7,91,62,0,160
Wilkes Rayle City Hall,Rayle City Hall,1,64,173,0,238
Wilkes Courthouse,Courthouse,15,288,103,1,407
Wilkes Tignall Sch Lunch Rm,Tignall Sch Lunch Rm,4,113,238,0,355
Wilkenson Bloodworth,Bloodworth,5,65,216,0,286
Wilkenson Griffin,Griffin,4,22,85,0,111
Wilkenson High Hill,High Hill,1,16,83,0,100
Wilkenson Irwinton,Irwinton,8,123,115,0,246
Wilkenson Ivey,Ivey,16,90,320,0,426
Wilkenson Lord,Lord,10,77,180,0,267
Wilkenson Midway,Midway,8,46,54,0,108
Wilkenson Ramah,Ramah,18,155,341,0,514
Wilkenson Turkey Creek,Turkey Creek,5,42,167,0,214
Worth Sylvester ,Sylvester ,12,288,212,1,513
Worth Scooterville ,Scooterville ,2,86,267,0,355
Worth Minton,Minton,13,245,350,1,609
Worth Bridgeboro,Bridgeboro,8,146,227,0,381
Worth County Line,County Line,5,114,197,0,316
Worth Isabella ,Isabella ,13,230,260,0,503
Worth Sylvester East,Sylvester East,19,409,390,2,820
Worth Poulan ,Poulan ,5,167,274,0,446
Worth Sumner,Sumner,6,156,283,1,446
Worth Red Rock,Red Rock,8,134,315,0,457
Worth Doles,Doles,4,69,140,1,214
Worth Warwick,Warwick,7,77,272,0,356
