ID,Counties,Absentee by Mail Votes,Advance Voting Votes,Election Day Votes,Provisional Votes,Total
Appling 1B,1B,17,42,27,0,86
Appling 1C,1C,2,29,20,0,51
Appling 2,2,79,363,199,0,641
Appling 3A1,3A1,3,10,10,0,23
Appling 3C,3C,34,127,52,0,213
Appling 4B,4B,1,8,14,0,23
Appling 4D,4D,11,47,34,0,92
Appling 5A,5A,4,48,24,0,76
Appling 5B,5B,4,20,31,0,55
Atkinson Pearson County,Pearson County,11,65,25,0,101
Atkinson Axson,Axson,0,5,16,0,21
Atkinson Willacoochee,Willacoochee,2,100,85,0,187
Atkinson Pearson City,Pearson City,9,121,63,0,193
Bacon Douglas,Douglas,41,283,134,0,458
Baker Anna,Anna,25,80,36,0,141
Baker Elmodel,Elmodel,7,34,15,0,56
Baker Hoggards Mill,Hoggards Mill,20,83,47,1,151
Baker Milford,Milford,18,32,26,0,76
Baker Newton,Newton,17,43,39,3,102
Baldwin Scottboro,Scottboro,14,100,89,0,203
Baldwin North Baldwin,North Baldwin,59,473,169,0,701
Baldwin West Baldwin,West Baldwin,69,294,152,1,516
Baldwin East Hardwick,East Hardwick,34,198,144,0,376
Baldwin West Hardwick,West Hardwick,148,632,350,0,1130
Baldwin Coopers,Coopers,23,151,91,0,265
Baldwin South Milledgeville,South Milledgeville,63,272,114,0,449
Baldwin City Hall Annex,City Hall Annex,21,115,77,1,214
Baldwin Boddie,Boddie,51,199,128,0,378
Baldwin Courthouse,Courthouse,14,66,28,0,108
Baldwin West Thomas,West Thomas,102,344,143,0,589
Baldwin North Milledgeville,North Milledgeville,65,454,176,0,695
Baldwin Meriwether,Meriwether,61,474,182,0,717
Baldwin East Baldwin,East Baldwin,95,571,320,0,986
Banks Anderson,Anderson,9,52,27,0,88
Banks Baldwin,Baldwin,11,42,24,0,77
Banks Berlin,Berlin,0,26,11,0,37
Banks Bushville,Bushville,3,25,19,0,47
Banks Columbia,Columbia,2,9,3,0,14
Banks Davids,Davids,9,69,45,0,123
Banks Golden Hill,Golden Hill,8,32,18,0,58
Banks Grove River,Grove River,3,9,3,0,15
Banks Hollingsworth,Hollingsworth,7,26,13,0,46
Banks Homer,Homer,10,40,22,0,72
Banks Poplar Springs,Poplar Springs,9,60,34,0,103
Banks Washington,Washington,10,33,11,0,54
Banks Wilmonts,Wilmonts,3,23,12,0,38
Barrow 01,01,37,219,194,0,450
Barrow 02,02,82,450,279,0,811
Barrow 03,03,58,355,355,2,770
Barrow 04,04,36,230,147,0,413
Barrow 05,05,134,794,548,0,1476
Barrow 08,08,81,575,289,1,946
Barrow 13,13,161,1118,630,0,1909
Barrow 16,16,110,793,565,1,1469
Bartow Adairsville,Adairsville,62,485,242,1,790
Bartow Allatoona,Allatoona,42,316,186,0,544
Bartow Cartersville East,Cartersville East,116,636,345,0,1097
Bartow Cartersville West,Cartersville West,121,850,406,1,1378
Bartow Cassville,Cassville,59,371,167,2,599
Bartow Center,Center,55,242,157,0,454
Bartow Emerson,Emerson,49,153,134,0,336
Bartow Euharlee,Euharlee,50,318,285,0,653
Bartow Folsom,Folsom,12,28,51,1,92
Bartow Kingston,Kingston,21,95,134,0,250
Bartow Mission Road,Mission Road,50,341,161,0,552
Bartow Pine Log,Pine Log,13,51,69,0,133
Bartow Taylorsville,Taylorsville,12,70,76,0,158
Bartow White,White,18,90,132,0,240
Bartow Zena Drive,Zena Drive,95,575,295,0,965
Bartow Hamilton Crossing,Hamilton Crossing,99,510,272,0,881
Bartow Woodland,Woodland,21,136,70,0,227
Ben Hill East,East,149,1184,434,0,1767
Berrien West Berrien,West Berrien,8,24,24,0,56
Berrien Ray City ,Ray City ,10,56,81,0,147
Berrien Nashville,Nashville,60,275,138,1,474
Berrien Enigma,Enigma,9,21,32,0,62
Berrien Alapaha ,Alapaha ,19,65,86,0,170
Bibb East Macon 1,East Macon 1,87,312,221,1,621
Bibb East Macon 2,East Macon 2,206,911,454,7,1578
Bibb East Macon 3,East Macon 3,125,637,408,2,1172
Bibb East Macon 4,East Macon 4,132,444,388,0,964
Bibb East Macon 5,East Macon 5,130,525,359,0,1014
Bibb Godfrey 1,Godfrey 1,295,1230,590,7,2122
Bibb Godfrey 2,Godfrey 2,63,241,222,0,526
Bibb Godfrey 3,Godfrey 3,100,619,332,4,1055
Bibb Godfrey 4,Godfrey 4,83,271,209,0,563
Bibb Godfrey 5,Godfrey 5,158,844,674,1,1677
Bibb Hazzard 1,Hazzard 1,116,629,446,2,1193
Bibb Hazzard 2,Hazzard 2,72,554,539,4,1169
Bibb Hazzard 3,Hazzard 3,311,1500,706,7,2524
Bibb Hazzard 4,Hazzard 4,95,783,493,4,1375
Bibb Howard 1,Howard 1,106,427,246,1,780
Bibb Howard 2,Howard 2,101,428,272,5,806
Bibb Howard 3,Howard 3,159,908,601,3,1671
Bibb Howard 4,Howard 4,60,271,156,0,487
Bibb Howard 5,Howard 5,55,345,282,0,682
Bibb Howard 6,Howard 6,72,323,190,2,587
Bibb Howard 7,Howard 7,66,412,295,1,774
Bibb Rutland 1,Rutland 1,122,953,481,4,1560
Bibb Rutland 2,Rutland 2,61,413,277,1,752
Bibb Vineville 1,Vineville 1,132,578,402,1,1113
Bibb Vineville 2,Vineville 2,84,348,277,2,711
Bibb Vineville 3,Vineville 3,139,641,386,7,1173
Bibb Vineville 4,Vineville 4,197,740,563,5,1505
Bibb Vineville 5,Vineville 5,45,386,263,1,695
Bibb Vineville 6,Vineville 6,63,506,321,1,891
Bibb Warrior 1,Warrior 1,54,324,224,0,602
Bibb Warrior 2,Warrior 2,73,474,214,2,763
Bleckley 1,1,117,504,418,0,1039
Brantley Hoboken,Hoboken,5,60,47,0,112
Brantley Nahunta,Nahunta,8,104,70,0,182
Brantley Waynesville,Waynesville,15,83,85,0,183
Brooks Quitman ,Quitman ,137,579,269,4,989
Brooks Barwick,Barwick,8,23,27,0,58
Brooks Dixie,Dixie,51,150,85,0,286
Brooks Briggs,Briggs,10,108,106,0,224
Brooks Pavo,Pavo,8,12,55,0,75
Brooks Nankin,Nankin,3,38,20,0,61
Brooks Morven,Morven,45,146,113,2,306
Bryan Harn Community Center,Harn Community Center,23,283,117,0,423
Bryan Danielsiding,Danielsiding,38,201,95,0,334
Bryan Christ Baptist Church,Christ Baptist Church,41,194,130,0,365
Bryan Black Creek,Black Creek,13,101,78,0,192
Bryan First Baptist Church,First Baptist Church,65,536,217,0,818
Bryan RH Rec Complex,RH Rec Complex,45,441,172,1,659
Bryan John Stevens Wetland Ctr,John Stevens Wetland Ctr,28,359,88,1,476
Bryan New Life,New Life,39,550,184,0,773
Bryan New Beginnings,New Beginnings,64,348,107,0,519
Bryan Bryan County Admin Bldg,Bryan County Admin Bldg,54,578,213,0,845
Bulloch Lockhart,Lockhart,10,42,52,0,104
Bulloch Emit,Emit,69,322,207,0,598
Bulloch Statesboro,Statesboro,126,903,483,0,1512
Bulloch Portal,Portal,20,93,124,0,237
Bulloch Fair,Fair,111,794,324,2,1231
Bulloch Church,Church,155,893,455,2,1505
Bulloch Pittman Park,Pittman Park,50,466,406,1,923
Bulloch Leefield,Leefield,16,27,54,0,97
Bulloch Blitch,Blitch,42,226,105,0,373
Bulloch Hagin,Hagin,54,230,173,2,459
Bulloch Brooklet,Brooklet,39,251,186,0,476
Bulloch Stilson,Stilson,20,70,93,0,183
Bulloch Bay,Bay,15,52,79,1,147
Bulloch Nevils,Nevils,12,54,63,0,129
Bulloch Sinkhole,Sinkhole,7,18,20,1,46
Bulloch Register,Register,17,85,73,0,175
Burke Alexander,Alexander,15,44,33,1,93
Burke Four Points,Four Points,29,207,175,1,412
Burke Girard,Girard,27,49,107,0,183
Burke Gough,Gough,19,62,67,0,148
Burke Greenscut,Greenscut,20,82,114,0,216
Burke Keysville,Keysville,7,11,84,0,102
Burke Midville,Midville,18,23,115,0,156
Burke Munnerlyn,Munnerlyn,4,18,25,0,47
Burke Sardis,Sardis,16,43,118,0,177
Burke Scotts Crossroads,Scotts Crossroads,6,33,41,0,80
Burke Telfair,Telfair,37,123,92,0,252
Burke St Clair,St Clair,16,46,48,0,110
Burke Vidette,Vidette,7,24,50,1,82
Burke North Waynesboro,North Waynesboro,134,473,306,0,913
Burke South Waynesboro,South Waynesboro,81,420,245,2,748
Burke Blakeney,Blakeney,14,81,70,1,166
Butts Butts County Recreation Center,Butts County Recreation Center,96,775,239,0,1110
Butts Jenkinsburg City Hall,Jenkinsburg City Hall,40,356,91,0,487
Butts Rock Creek Missionary,Rock Creek Missionary,39,288,91,0,418
Butts Stark United Methodist Church,Stark United Methodist Church,14,155,36,0,205
Butts Towaliga Baptist Church,Towaliga Baptist Church,28,329,89,0,446
Calhoun Leary ,Leary ,25,97,108,1,231
Calhoun Morgan,Morgan,19,61,25,0,105
Calhoun Edison ,Edison ,17,71,117,0,205
Calhoun Edison-Arlington,Edison-Arlington,12,88,91,0,191
Calhoun Arlington,Arlington,27,67,137,0,231
Camden Tarboro,Tarboro,29,51,66,1,147
Camden Waverly,Waverly,55,115,116,0,286
Camden Woodbine,Woodbine,62,217,111,0,390
Camden Browntown,Browntown,7,24,17,0,48
Camden Harriets Bluff,Harriets Bluff,17,139,73,0,229
Camden West Kingsland,West Kingsland,27,208,95,0,330
Camden North Kingsland,North Kingsland,62,309,154,0,525
Camden Kingsland,Kingsland,23,182,132,0,337
Camden East Kingsland,East Kingsland,106,835,293,0,1234
Camden North St. Marys,North St. Marys,21,112,96,0,229
Camden St. Marys ,St. Marys ,55,316,190,0,561
Camden South St. Marys,South St. Marys,72,233,120,0,425
Camden Mush Bluff,Mush Bluff,34,260,141,0,435
Camden West St. Marys ,West St. Marys ,62,376,144,0,582
Candler JSCC,JSCC,82,603,265,0,950
Carroll Kansas,Kansas,8,23,31,0,62
Carroll Bowdon,Bowdon,21,151,185,1,358
Carroll Sandhill,Sandhill,46,374,196,1,617
Carroll Center Point,Center Point,4,93,69,0,166
Carroll Mt Zion,Mt Zion,21,112,106,0,239
Carroll Burwell,Burwell,15,62,75,0,152
Carroll Clem,Clem,34,299,165,0,498
Carroll Bowdon Junction,Bowdon Junction,5,99,65,0,169
Carroll Tyus,Tyus,13,75,53,2,143
Carroll Fairfield,Fairfield,59,369,252,0,680
Carroll Hulett,Hulett,22,121,116,0,259
Carroll Bethany,Bethany,41,485,225,1,752
Carroll V R County South,V R County South,29,190,91,0,310
Carroll V R County North,V R County North,59,479,314,0,852
Carroll Villa Rica City,Villa Rica City,117,969,550,0,1636
Carroll Temple County,Temple County,36,197,151,0,384
Carroll Temple City,Temple City,54,329,313,0,696
Carroll Whitesburg,Whitesburg,14,90,90,0,194
Carroll Roopville,Roopville,26,133,105,0,264
Carroll West Carrollton,West Carrollton,59,592,321,1,973
Carroll Lakeshore Rec Center,Lakeshore Rec Center,26,229,98,0,353
Carroll Bonner,Bonner,49,462,255,0,766
Carroll University of W GA,University of W GA,10,162,145,0,317
Carroll County Admin Bldg,County Admin Bldg,48,399,146,0,593
Carroll Tabernacle Church,Tabernacle Church,32,189,115,0,336
Carroll Burson Center,Burson Center,28,172,80,0,280
Carroll Old Camp Church,Old Camp Church,22,183,128,0,333
Carroll Oak Grove,Oak Grove,17,117,66,0,200
Catoosa Blackstock,Blackstock,10,83,55,0,148
Catoosa Boynton,Boynton,45,470,253,0,768
Catoosa Catoosa Keith,Catoosa Keith,25,140,102,1,268
Catoosa Chambers,Chambers,25,171,96,0,292
Catoosa Ft Oglethorpe,Ft Oglethorpe,33,283,176,0,492
Catoosa Graysville,Graysville,63,241,219,0,523
Catoosa Lakeview,Lakeview,27,184,125,0,336
Catoosa Poplar Springs,Poplar Springs,36,251,145,0,432
Catoosa Ringgold,Ringgold,89,679,248,0,1016
Catoosa Westside,Westside,55,451,183,0,689
Catoosa Woodstation,Woodstation,22,164,131,1,318
Charlton Folkston,Folkston,54,433,216,0,703
Charlton GA Bend,GA Bend,1,3,14,0,18
Charlton St. George ,St. George ,0,1,7,0,8
Charlton Homeland,Homeland,1,16,15,0,32
Charlton Racepond,Racepond,0,6,4,0,10
Charlton Winokur,Winokur,2,4,3,0,9
Chatham 1-01C First Presbyterian Church,1-01C First Presbyterian Church,138,690,610,0,1438
Chatham 1-05C JEA Building,1-05C JEA Building,83,447,384,1,915
Chatham 1-06C Central Church of Christ,1-06C Central Church of Christ,77,331,238,0,646
Chatham 1-08C Grace United Methodist Church,1-08C Grace United Methodist Church,48,248,184,0,480
Chatham 1-09C Immanuel Baptist Church,1-09C Immanuel Baptist Church,39,271,208,0,518
Chatham 1-10C St Thomas Episcopal Church,1-10C St Thomas Episcopal Church,13,89,139,0,241
Chatham 1-12C Isle of Hope Baptist,1-12C Isle of Hope Baptist,51,244,199,0,494
Chatham 1-13C The Sanctuary,1-13C The Sanctuary,47,160,148,0,355
Chatham 1-14C St. Luke United Methodist Church,1-14C St. Luke United Methodist Church,61,253,107,0,421
Chatham 1-16C Ferguson Ave Baptist,1-16C Ferguson Ave Baptist,55,248,213,0,516
Chatham 1-17C Islands Christian Church,1-17C Islands Christian Church,83,385,199,1,668
Chatham 2-02C River Pointe,2-02C River Pointe,45,279,227,0,551
Chatham 2-03C W W Law Center,2-03C W W Law Center,45,225,279,1,550
Chatham 2-04C Fellowship of Love Church,2-04C Fellowship of Love Church,126,436,446,0,1008
Chatham 2-05C Holy Spirit Lutheran Church,2-05C Holy Spirit Lutheran Church,102,539,567,1,1209
Chatham 2-06C Eli Whitney Complex - Savannah,2-06C Eli Whitney Complex - Savannah,8,90,110,0,208
Chatham 2-06C Eli Whitney Complex,2-06C Eli Whitney Complex,36,138,109,0,283
Chatham 2-07C Christ Community Church,2-07C Christ Community Church,89,471,470,2,1032
Chatham 2-09C Salvation Army,2-09C Salvation Army,154,679,525,0,1358
Chatham 2-11C Oasis of Hope,2-11C Oasis of Hope,63,281,256,0,600
Chatham 2-12C Williams Court Apts,2-12C Williams Court Apts,67,276,328,1,672
Chatham 3-02C Temple Mickve Israel,3-02C Temple Mickve Israel,78,390,177,1,646
Chatham 3-03C Savannah High School,3-03C Savannah High School,32,157,212,1,402
Chatham 3-04C First African Baptist Church,3-04C First African Baptist Church,54,241,323,0,618
Chatham 3-05C New Generations Cathedral,3-05C New Generations Cathedral,48,306,334,0,688
Chatham 3-08C Jenkins High School,3-08C Jenkins High School,37,236,180,0,453
Chatham 3-09C The Connexion Church,3-09C The Connexion Church,23,71,119,0,213
Chatham 3-10C Bible Baptist Church,3-10C Bible Baptist Church,103,511,466,0,1080
Chatham 3-11C Southside Baptist Church,3-11C Southside Baptist Church,44,242,290,1,577
Chatham 3-12C Thunderbolt Muni Complex,3-12C Thunderbolt Muni Complex,58,198,233,0,489
Chatham 3-13C New Cov 7 Day Adv Ch,3-13C New Cov 7 Day Adv Ch,62,323,265,1,651
Chatham 3-14C Oglethorpe Charter Academy,3-14C Oglethorpe Charter Academy,80,482,215,0,777
Chatham 3-14C Oglethorpe Charter Academy - Savannah,3-14C Oglethorpe Charter Academy - Savannah,16,108,60,2,186
Chatham 4-02C Islands High School Annex,4-02C Islands High School Annex,50,287,174,0,511
Chatham 4-04C Lighthouse Baptist Church,4-04C Lighthouse Baptist Church,61,277,182,0,520
Chatham 4-05C St Francis Episcopal Church,4-05C St Francis Episcopal Church,77,254,195,0,526
Chatham 4-06C First Baptist of the Island,4-06C First Baptist of the Island,57,230,162,0,449
Chatham 4-07C Wilmington Island UMC,4-07C Wilmington Island UMC,67,447,236,0,750
Chatham 4-08C Wilmington Island Pres Church,4-08C Wilmington Island Pres Church,67,333,191,0,591
Chatham 4-10C Burke Day Public Safety BLDG,4-10C Burke Day Public Safety BLDG,35,174,199,0,408
Chatham 4-11C Island Old School Cafe,4-11C Island Old School Cafe,29,163,277,0,469
Chatham 4-12C St Peters Episcopal,4-12C St Peters Episcopal,77,256,245,0,578
Chatham 4-13C Skidaway Community Church,4-13C Skidaway Community Church,98,361,271,0,730
Chatham 4-14C Skidaway Island Methodist Church,4-14C Skidaway Island Methodist Church,207,550,346,0,1103
Chatham 5-02C Senior Citizens Center,5-02C Senior Citizens Center,18,101,147,1,267
Chatham 5-03C Butler Presbyterian Church,5-03C Butler Presbyterian Church,58,131,223,0,412
Chatham 5-05C Liberty City Comm Ctr,5-05C Liberty City Comm Ctr,174,584,528,1,1287
Chatham 5-06C Seed Church,5-06C Seed Church,75,345,271,1,692
Chatham 5-06C Seed Church - Savannah,5-06C Seed Church - Savannah,4,29,20,0,53
Chatham 5-07C Elks Lodge,5-07C Elks Lodge,30,285,215,0,530
Chatham 5-08C Savannah Primitive BC,5-08C Savannah Primitive BC,53,281,288,2,624
Chatham 5-10C Jonesville Baptist Church,5-10C Jonesville Baptist Church,168,596,621,0,1385
Chatham 5-11C Largo-Tibet Elementary,5-11C Largo-Tibet Elementary,87,514,343,1,945
Chatham 6-01C White Bluff Presbyterian,6-01C White Bluff Presbyterian,48,294,222,1,565
Chatham 6-02C Windsor Forest Baptist - Savannah,6-02C Windsor Forest Baptist - Savannah,69,363,198,0,630
Chatham 6-02C Windsor Forest Baptist,6-02C Windsor Forest Baptist,4,16,6,0,26
Chatham 6-03C Crusader Comm Center,6-03C Crusader Comm Center,105,558,309,0,972
Chatham 6-05C Windsor Hall,6-05C Windsor Hall,51,319,266,0,636
Chatham 6-06C The Light Church,6-06C The Light Church,30,197,132,0,359
Chatham 6-08C Christ Memorial Baptist Church,6-08C Christ Memorial Baptist Church,51,397,236,0,684
Chatham 6-09C Trinity Lutheran Church,6-09C Trinity Lutheran Church,76,559,342,0,977
Chatham 6-10C Georgetown Elementary,6-10C Georgetown Elementary,145,705,374,0,1224
Chatham 6-10C Georgetown Elementary - Savannah,6-10C Georgetown Elementary - Savannah,4,28,17,1,50
Chatham 6-11C Coastal GA Botanical Gardens,6-11C Coastal GA Botanical Gardens,65,283,149,0,497
Chatham 6-11C Coastal GA Botanical Gardens - Savannah,6-11C Coastal GA Botanical Gardens - Savannah,99,667,321,0,1087
Chatham 7-01C First Baptist Church of Garden City,7-01C First Baptist Church of Garden City,30,160,152,0,342
Chatham 7-03C PB Edwards Gym,7-03C PB Edwards Gym,9,58,102,0,169
Chatham 7-04C Lake Shore Comm Ctr,7-04C Lake Shore Comm Ctr,55,494,544,2,1095
Chatham 7-05C Woodlawn Baptist Church,7-05C Woodlawn Baptist Church,31,141,141,1,314
Chatham 7-06C 1st Baptist Church of Pooler,7-06C 1st Baptist Church of Pooler,103,423,293,1,820
Chatham 7-07C Rothwell Baptist Church,7-07C Rothwell Baptist Church,96,432,218,0,746
Chatham 7-08C Bloomingdale Comm Ctr,7-08C Bloomingdale Comm Ctr,35,123,142,1,301
Chatham 7-08C Bloomingdale Comm Ctr - Savannah,7-08C Bloomingdale Comm Ctr - Savannah,10,27,16,0,53
"Chatham 7-09C Compassion Christian, Henderson","7-09C Compassion Christian, Henderson",89,369,293,2,753
"Chatham 7-09C Compassion Christian, Henderson - Savannah","7-09C Compassion Christian, Henderson - Savannah",0,0,0,0,0
Chatham 7-10C Progressive Rec Center,7-10C Progressive Rec Center,124,729,407,1,1261
Chatham 7-11C Savannah Fire Station 14,7-11C Savannah Fire Station 14,84,442,313,0,839
Chatham 7-12C West Chatham Baptist Church,7-12C West Chatham Baptist Church,101,681,325,3,1110
Chatham 7-13C Southside Fire Trng Ctr,7-13C Southside Fire Trng Ctr,129,452,168,0,749
Chatham 7-13C Southside Fire Trng Ctr - Garden City,7-13C Southside Fire Trng Ctr - Garden City,0,0,0,0,0
Chatham 7-14C Coastal Cathedral,7-14C Coastal Cathedral,267,1498,940,4,2709
Chatham 7-15C Rice Creek School,7-15C Rice Creek School,48,368,421,1,838
Chatham 7-16C Pooler Recreation Center Gymnasium,7-16C Pooler Recreation Center Gymnasium,144,711,319,0,1174
Chatham 8-01C R.M.G. Civil Rights Museum,8-01C R.M.G. Civil Rights Museum,38,241,146,0,425
Chatham 8-02C Hellenic Center,8-02C Hellenic Center,60,345,298,0,703
Chatham 8-03C Silk Hope Baptist Church,8-03C Silk Hope Baptist Church,7,57,71,1,136
Chatham 8-03C Silk Hope Baptist Church - Garden City,8-03C Silk Hope Baptist Church - Garden City,0,0,0,0,0
Chatham 8-05C W Broad St YMCA,8-05C W Broad St YMCA,32,178,220,0,430
Chatham 8-06C Tompkins Rec Center,8-06C Tompkins Rec Center,47,139,193,0,379
Chatham 8-07C Woodville-Tompkins TI,8-07C Woodville-Tompkins TI,18,79,127,0,224
Chatham 8-08C Resur of Our Lord Church,8-08C Resur of Our Lord Church,80,233,332,0,645
Chatham 8-09C Moses Jackson Center,8-09C Moses Jackson Center,72,199,268,0,539
Chatham 8-10C Carver Heights Comm Ctr,8-10C Carver Heights Comm Ctr,130,265,362,1,758
Chatham 8-11C Butler Elementary,8-11C Butler Elementary,98,312,338,1,749
Chatham 8-12C Beach High School,8-12C Beach High School,29,188,218,0,435
Chatham 8-13C Savannah Christian,8-13C Savannah Christian,19,56,46,0,121
Chatham 8-15C Cooper Center,8-15C Cooper Center,51,254,234,0,539
Chatham 8-16C Mighty 8th Museum,8-16C Mighty 8th Museum,117,500,319,0,936
Chatham 8-17C Georgia Tech Savannah Campus,8-17C Georgia Tech Savannah Campus,79,463,344,3,889
Chatham 8-18C Savannah First 7th Day Adv Church,8-18C Savannah First 7th Day Adv Church,24,138,173,0,335
Chattahoochee Activity Center,Activity Center,27,256,170,0,453
Chattooga Haywood,Haywood,0,3,10,0,13
Chattooga Lyerly,Lyerly,15,83,78,0,176
Chattooga Trion,Trion,30,203,128,0,361
Chattooga Summerville,Summerville,56,374,225,0,655
Chattooga Dirttown,Dirttown,8,46,49,0,103
Chattooga Subligna,Subligna,2,11,15,0,28
Chattooga Menlo,Menlo,9,91,78,0,178
Cherokee Air Acres,Air Acres,77,360,264,0,701
Cherokee Arnold Mill,Arnold Mill,119,490,312,0,921
Cherokee Avery,Avery,64,337,170,0,571
Cherokee Ball Ground,Ball Ground,33,264,130,0,427
Cherokee Bascomb,Bascomb,69,462,295,0,826
Cherokee Bells,Bells,110,901,456,0,1467
Cherokee Booth,Booth,86,501,234,1,822
Cherokee Bradshaw,Bradshaw,108,514,227,0,849
Cherokee Bridgemill,Bridgemill,80,496,260,0,836
Cherokee Canton,Canton,245,1042,368,0,1655
Cherokee Carmel,Carmel,127,541,375,2,1045
Cherokee Clayton,Clayton,90,503,191,0,784
Cherokee Conns Creek,Conns Creek,5,35,23,0,63
Cherokee Deer Run,Deer Run,68,315,277,0,660
Cherokee Dixie,Dixie,107,623,409,0,1139
Cherokee Freehome,Freehome,116,535,192,0,843
Cherokee Hickory Flat,Hickory Flat,200,866,523,0,1589
Cherokee Hightower,Hightower,43,273,96,0,412
Cherokee Hillside,Hillside,70,370,148,1,589
Cherokee Holly Springs,Holly Springs,44,198,177,0,419
Cherokee Kellogg,Kellogg,104,540,374,0,1018
Cherokee Liberty,Liberty,167,830,493,0,1490
Cherokee Little River,Little River,350,1023,525,0,1898
Cherokee Macedonia,Macedonia,107,397,277,0,781
Cherokee Mountain Road,Mountain Road,59,303,191,0,553
Cherokee Neese,Neese,218,990,584,0,1792
Cherokee Oak Grove,Oak Grove,79,374,181,0,634
Cherokee R M Moore,R M Moore,44,147,108,0,299
Cherokee R T Jones,R T Jones,53,196,133,0,382
Cherokee Rosecreek,Rosecreek,67,431,236,1,735
Cherokee Salacoa,Salacoa,12,14,23,0,49
Cherokee Sixes,Sixes,70,301,179,1,551
Cherokee Sutallee,Sutallee,24,110,138,0,272
Cherokee Teasley,Teasley,125,745,453,1,1324
Cherokee Toonigh,Toonigh,111,722,473,1,1307
Cherokee Union Hill,Union Hill,72,303,225,0,600
Cherokee Univeter,Univeter,63,460,190,0,713
Cherokee Victoria,Victoria,39,257,179,2,477
Cherokee Waleska,Waleska,84,310,152,0,546
Cherokee Wildcat,Wildcat,53,234,214,0,501
Cherokee Woodlands,Woodlands,64,296,457,0,817
Cherokee Woodstock,Woodstock,150,975,503,2,1630
Clarke 1A,1A,74,592,358,0,1024
Clarke 1B,1B,152,904,365,0,1421
Clarke 1C,1C,142,622,337,0,1101
Clarke 1D,1D,114,771,398,0,1283
Clarke 2A,2A,166,665,561,1,1393
Clarke 2B,2B,184,981,567,0,1732
Clarke 3A,3A,102,513,336,4,955
Clarke 3B,3B,117,712,388,2,1219
Clarke 4A,4A,49,360,223,0,632
Clarke 4B,4B,106,745,468,1,1320
Clarke 5A,5A,110,867,446,0,1423
Clarke 5B,5B,136,696,437,0,1269
Clarke 5C,5C,67,738,449,0,1254
Clarke 5D,5D,84,532,512,2,1130
Clarke 6A,6A,142,774,357,4,1277
Clarke 6B,6B,186,882,424,3,1495
Clarke 6C,6C,113,669,373,0,1155
Clarke 6D,6D,74,426,303,1,804
Clarke 7A,7A,116,606,376,0,1098
Clarke 7B,7B,124,672,314,0,1110
Clarke 7C,7C,94,540,328,1,963
Clarke 8A,8A,129,731,374,0,1234
Clarke 8B,8B,96,487,313,1,897
Clarke 8C,8C,129,743,505,0,1377
Clay Bluffton,Bluffton,8,29,40,0,77
Clay Zetto ,Zetto ,10,53,45,0,108
Clay Court House,Court House,18,52,71,0,141
Clay Old Head Start,Old Head Start,29,65,37,0,131
Clay Days Cross Road,Days Cross Road,10,76,29,0,115
Clayton Ellenwood 1,Ellenwood 1,77,1237,283,2,1599
Clayton Ellenwood 2,Ellenwood 2,102,1392,331,0,1825
Clayton Forest Park 1,Forest Park 1,39,513,288,2,842
Clayton Forest Park 2,Forest Park 2,58,510,317,0,885
Clayton Forest Park 3,Forest Park 3,75,529,238,2,844
Clayton Forest Park 4,Forest Park 4,26,285,164,1,476
Clayton Forest Park 5,Forest Park 5,69,585,347,3,1004
Clayton Forest Park 6,Forest Park 6,24,291,119,0,434
Clayton Jonesboro 1,Jonesboro 1,100,885,323,0,1308
Clayton Jonesboro 2,Jonesboro 2,52,574,195,2,823
Clayton Jonesboro 3,Jonesboro 3,33,237,100,0,370
Clayton Jonesboro 4,Jonesboro 4,32,423,221,2,678
Clayton Jonesboro 5,Jonesboro 5,44,461,236,0,741
Clayton Jonesboro 6,Jonesboro 6,107,737,139,0,983
Clayton Jonesboro 7,Jonesboro 7,94,827,333,0,1254
Clayton Jonesboro 8,Jonesboro 8,42,714,444,2,1202
Clayton Jonesboro 9,Jonesboro 9,28,275,137,0,440
Clayton Jonesboro 10,Jonesboro 10,75,631,315,2,1023
Clayton Jonesboro 11,Jonesboro 11,90,760,206,1,1057
Clayton Jonesboro 12,Jonesboro 12,70,764,315,1,1150
Clayton Jonesboro 13,Jonesboro 13,53,720,279,1,1053
Clayton Jonesboro 14,Jonesboro 14,142,1281,369,4,1796
Clayton Jonesboro 15,Jonesboro 15,25,518,230,0,773
Clayton Jonesboro 16,Jonesboro 16,56,505,298,3,862
Clayton Jonesboro 17,Jonesboro 17,89,754,308,1,1152
Clayton Jonesboro 18,Jonesboro 18,60,830,340,0,1230
Clayton Jonesboro 19,Jonesboro 19,95,918,293,2,1308
Clayton Jonesboro 20,Jonesboro 20,82,732,226,1,1041
Clayton Jonesboro 21,Jonesboro 21,111,953,301,1,1366
Clayton Jonesboro 22,Jonesboro 22,55,483,151,0,689
Clayton Lake City,Lake City,82,711,279,1,1073
Clayton Lovejoy 1,Lovejoy 1,105,1307,493,3,1908
Clayton Lovejoy 2,Lovejoy 2,69,928,333,0,1330
Clayton Lovejoy 3,Lovejoy 3,28,608,193,0,829
Clayton Lovejoy 4,Lovejoy 4,66,899,209,3,1177
Clayton Lovejoy 5,Lovejoy 5,74,889,354,2,1319
Clayton Lovejoy 6,Lovejoy 6,83,1217,369,2,1671
Clayton Lovejoy 7,Lovejoy 7,66,957,324,2,1349
Clayton Lovejoy 8,Lovejoy 8,35,518,130,0,683
Clayton Morrow 1,Morrow 1,52,642,423,2,1119
Clayton Morrow 2,Morrow 2,55,429,153,1,638
Clayton Morrow 3,Morrow 3,42,620,231,0,893
Clayton Morrow 4,Morrow 4,51,441,225,0,717
Clayton Morrow 5,Morrow 5,56,1010,326,0,1392
Clayton Morrow 6,Morrow 6,60,826,291,0,1177
Clayton Morrow 7,Morrow 7,39,386,253,3,681
Clayton Morrow 8,Morrow 8,84,1056,330,1,1471
Clayton Morrow 9,Morrow 9,35,325,138,0,498
Clayton Morrow 10,Morrow 10,35,793,163,0,991
Clayton Morrow 11,Morrow 11,43,597,214,2,856
Clayton Oak 1,Oak 1,39,630,302,3,974
Clayton Oak 2,Oak 2,35,298,238,1,572
Clayton Oak 3,Oak 3,33,609,319,1,962
Clayton Oak 4,Oak 4,52,687,334,1,1074
Clayton Oak 5,Oak 5,28,300,164,2,494
Clayton Oak 6,Oak 6,15,309,119,0,443
Clayton Panhandle 1,Panhandle 1,91,1032,373,1,1497
Clayton Panhandle 2,Panhandle 2,96,1185,438,0,1719
Clayton Riverdale 1,Riverdale 1,86,887,230,0,1203
Clayton Riverdale 2,Riverdale 2,95,850,362,0,1307
Clayton Riverdale 3,Riverdale 3,68,1032,405,2,1507
Clayton Riverdale 4,Riverdale 4,120,926,422,5,1473
Clayton Riverdale 5,Riverdale 5,59,727,306,1,1093
Clayton Riverdale 6,Riverdale 6,77,527,339,2,945
Clayton Riverdale 7,Riverdale 7,35,401,292,1,729
Clayton Riverdale 8,Riverdale 8,98,1022,326,0,1446
Clayton Riverdale 9,Riverdale 9,63,603,304,0,970
Clayton Riverdale 10,Riverdale 10,32,494,271,0,797
Clayton Riverdale 11,Riverdale 11,62,656,205,1,924
Clayton Riverdale 12,Riverdale 12,102,832,366,3,1303
Clinch Arabia,Arabia,1,3,4,0,8
Clinch Argyle,Argyle,1,11,13,0,25
Clinch Dupont,Dupont,3,6,19,0,28
Clinch Fargo,Fargo,0,5,15,0,20
Clinch Homerville,Homerville,22,197,139,0,358
Cobb Acworth 1A,Acworth 1A,157,1057,419,3,1636
Cobb Acworth 1B,Acworth 1B,145,816,385,0,1346
Cobb Acworth 1C,Acworth 1C,100,1068,362,8,1538
Cobb Addison 01,Addison 01,114,464,251,1,830
Cobb Austell 1A,Austell 1A,52,647,209,1,909
Cobb Austell 1B,Austell 1B,67,820,233,3,1123
Cobb Baker 01,Baker 01,80,832,513,1,1426
Cobb Bells Ferry 02,Bells Ferry 02,96,450,322,0,868
Cobb Bells Ferry 03,Bells Ferry 03,62,329,248,1,640
Cobb Bells Ferry 04,Bells Ferry 04,75,480,323,1,879
Cobb Big Shanty 01,Big Shanty 01,53,296,187,4,540
Cobb Big Shanty 02,Big Shanty 02,98,510,378,0,986
Cobb Birney 01,Birney 01,101,512,289,0,902
Cobb Birney 02,Birney 02,166,1113,398,2,1679
Cobb Bryant 01,Bryant 01,78,731,244,2,1055
Cobb Bryant 02,Bryant 02,102,1276,623,2,2003
Cobb Blackwell 01,Blackwell 01,115,479,307,0,901
Cobb Chattahoochee 01,Chattahoochee 01,114,1164,706,12,1996
Cobb Cheatham Hill 02,Cheatham Hill 02,68,636,249,0,953
Cobb Cheatham Hill 03,Cheatham Hill 03,138,924,387,1,1450
Cobb Chalker 01,Chalker 01,173,950,637,3,1763
Cobb Clarkdale 01,Clarkdale 01,53,377,176,0,606
Cobb Clarkdale 02,Clarkdale 02,133,1237,555,8,1933
Cobb Cooper 01,Cooper 01,161,1249,513,5,1928
Cobb Chestnut Ridge 01,Chestnut Ridge 01,117,553,325,0,995
Cobb Dickerson 01,Dickerson 01,130,529,289,1,949
Cobb Dobbins 01,Dobbins 01,51,364,235,3,653
Cobb Dobbins 02,Dobbins 02,86,616,417,5,1124
Cobb Dowell 01,Dowell 01,89,724,342,0,1155
Cobb Dodgen 01,Dodgen 01,81,350,259,1,691
Cobb Durham 01,Durham 01,101,626,214,0,941
Cobb Davis 01,Davis 01,55,374,271,1,701
Cobb Eastside 01,Eastside 01,163,540,298,2,1003
Cobb Eastside 02,Eastside 02,210,789,355,1,1355
Cobb Elizabeth 01,Elizabeth 01,95,723,435,1,1254
Cobb Elizabeth 02,Elizabeth 02,80,370,228,1,679
Cobb Elizabeth 03,Elizabeth 03,103,481,281,0,865
Cobb Elizabeth 04,Elizabeth 04,81,437,405,2,925
Cobb Elizabeth 05,Elizabeth 05,115,539,339,1,994
Cobb East Piedmont 01,East Piedmont 01,90,424,308,1,823
Cobb Fair Oaks 02,Fair Oaks 02,162,1081,480,3,1726
Cobb Fair Oaks 04,Fair Oaks 04,125,578,426,10,1139
Cobb Fullers Park 01,Fullers Park 01,136,595,390,0,1121
Cobb Ford 01,Ford 01,58,494,216,0,768
Cobb Frey 01,Frey 01,58,476,136,0,670
Cobb Garrison Mill 01,Garrison Mill 01,94,564,264,0,922
Cobb Gritters 01,Gritters 01,123,576,381,0,1080
Cobb Harmony-Leland 01,Harmony-Leland 01,77,757,239,2,1075
Cobb Harmony-Leland 02,Harmony-Leland 02,134,1513,420,6,2073
Cobb Harrison 01,Harrison 01,81,484,203,1,769
Cobb Hightower 01,Hightower 01,214,796,342,0,1352
Cobb Hayes 01,Hayes 01,88,670,247,1,1006
Cobb Kennesaw 1A,Kennesaw 1A,40,364,261,1,666
Cobb Kennesaw 2A,Kennesaw 2A,89,610,352,2,1053
Cobb Kennesaw 3A,Kennesaw 3A,148,1259,580,13,2000
Cobb Kennesaw 4A,Kennesaw 4A,83,652,353,0,1088
Cobb Kennesaw 5A,Kennesaw 5A,132,1114,712,4,1962
Cobb Kell 01,Kell 01,51,280,242,1,574
Cobb Kemp 01,Kemp 01,43,312,125,0,480
Cobb Kemp 02,Kemp 02,156,766,313,0,1235
Cobb Kemp 03,Kemp 03,88,626,229,0,943
Cobb Lassiter 01,Lassiter 01,88,685,323,1,1097
Cobb Lindley 01,Lindley 01,233,1724,546,1,2504
Cobb Lost Mountain 01,Lost Mountain 01,110,880,211,0,1201
Cobb Lost Mountain 02,Lost Mountain 02,77,635,223,2,937
Cobb Lost Mountain 03,Lost Mountain 03,127,1238,266,1,1632
Cobb Lost Mountain 04,Lost Mountain 04,60,459,157,0,676
Cobb Mableton 01,Mableton 01,169,1561,438,0,2168
Cobb Mableton 02,Mableton 02,72,740,326,1,1139
Cobb Mableton 03,Mableton 03,87,630,273,1,991
Cobb Mableton 04,Mableton 04,66,386,189,0,641
Cobb Mabry 01,Mabry 01,46,272,168,1,487
Cobb Macland 01,Macland 01,136,1202,415,1,1754
Cobb Murdock 01,Murdock 01,167,785,407,0,1359
Cobb McEachern 01,McEachern 01,121,1006,293,0,1420
Cobb McCleskey 01,McCleskey 01,41,312,199,0,552
Cobb McClure 01,McClure 01,67,493,247,1,808
Cobb Marietta 1A,Marietta 1A,121,701,367,2,1191
Cobb Marietta 2A,Marietta 2A,62,376,224,0,662
Cobb Marietta 2B,Marietta 2B,116,879,486,0,1481
Cobb Marietta 3A,Marietta 3A,149,855,456,0,1460
Cobb Marietta 3B,Marietta 3B,85,488,259,1,833
Cobb Marietta 4A,Marietta 4A,46,253,196,0,495
Cobb Marietta 4B,Marietta 4B,62,399,226,0,687
Cobb Marietta 4C,Marietta 4C,79,464,261,3,807
Cobb Marietta 5A,Marietta 5A,186,664,324,1,1175
Cobb Marietta 5B,Marietta 5B,48,439,319,3,809
Cobb Marietta 6A,Marietta 6A,52,386,262,1,701
Cobb Marietta 6B,Marietta 6B,116,605,360,0,1081
Cobb Marietta 7A,Marietta 7A,62,530,313,1,906
Cobb Mars Hill 01,Mars Hill 01,66,414,219,0,699
Cobb Mars Hill 02,Mars Hill 02,56,432,228,0,716
Cobb Mt. Bethel 01,Mt. Bethel 01,203,737,389,0,1329
Cobb Mt. Bethel 03,Mt. Bethel 03,152,657,242,1,1052
Cobb Mt. Bethel 04,Mt. Bethel 04,145,513,260,1,919
Cobb North Cobb 01,North Cobb 01,52,408,221,1,682
Cobb Nickajack 01,Nickajack 01,165,1492,656,4,2317
Cobb Norton Park 01,Norton Park 01,144,864,531,6,1545
Cobb Nicholson 01,Nicholson 01,72,359,262,0,693
Cobb Oakdale 01,Oakdale 01,184,940,488,2,1614
Cobb Oregon 01,Oregon 01,34,312,143,0,489
Cobb Oregon 02,Oregon 02,185,1338,619,4,2146
Cobb Oregon 03,Oregon 03,151,956,495,4,1606
Cobb Oregon 04,Oregon 04,211,1079,424,4,1718
Cobb Oregon 05,Oregon 05,126,1015,394,3,1538
Cobb Pebblebrook 01,Pebblebrook 01,139,1339,482,4,1964
Cobb Powers Ferry 01,Powers Ferry 01,112,507,425,0,1044
Cobb Pine Mountain 01,Pine Mountain 01,70,516,262,0,848
Cobb Pine Mountain 02,Pine Mountain 02,94,442,203,2,741
Cobb Post Oak 01,Post Oak 01,106,609,333,3,1051
Cobb Pope 01,Pope 01,112,623,235,1,971
Cobb Palmer 01,Palmer 01,79,385,225,0,689
Cobb Powder Springs 1A,Powder Springs 1A,171,1543,443,5,2162
Cobb Powder Springs 2A,Powder Springs 2A,115,961,272,5,1353
Cobb Powder Springs 3A,Powder Springs 3A,105,1088,482,3,1678
Cobb Pitner 01,Pitner 01,61,378,337,0,776
Cobb Rocky Mount 01,Rocky Mount 01,82,537,395,1,1015
Cobb Riverside 01,Riverside 01,39,412,217,6,674
Cobb Roswell 01,Roswell 01,276,991,520,0,1787
Cobb Roswell 02,Roswell 02,160,687,410,0,1257
Cobb Sandy Plains 01,Sandy Plains 01,90,559,311,0,960
Cobb Shallowford Falls 01,Shallowford Falls 01,136,620,360,0,1116
Cobb Simpson 01,Simpson 01,62,373,180,0,615
Cobb Sewell Mill 01,Sewell Mill 01,158,632,380,1,1171
Cobb Sewell Mill 03,Sewell Mill 03,145,761,502,3,1411
Cobb Smyrna 1A,Smyrna 1A,98,737,594,3,1432
Cobb Smyrna 2A,Smyrna 2A,168,1281,628,11,2088
Cobb Smyrna 3A,Smyrna 3A,127,1167,477,7,1778
Cobb Smyrna 3B,Smyrna 3B,77,618,286,2,983
Cobb Smyrna 4A,Smyrna 4A,235,1534,626,5,2400
Cobb Smyrna 5A,Smyrna 5A,129,881,488,12,1510
Cobb Smyrna 6A,Smyrna 6A,242,1506,574,1,2323
Cobb Smyrna 7A,Smyrna 7A,359,2386,611,3,3359
Cobb Sope Creek 01,Sope Creek 01,77,393,261,1,732
Cobb Sope Creek 02,Sope Creek 02,207,1026,525,3,1761
Cobb Sope Creek 03,Sope Creek 03,93,464,275,0,832
Cobb Sweetwater 01,Sweetwater 01,63,715,323,0,1101
Cobb Sweetwater 02,Sweetwater 02,132,614,320,0,1066
Cobb Terrell Mill 01,Terrell Mill 01,165,1029,592,10,1796
Cobb Timber Ridge 01,Timber Ridge 01,124,445,293,0,862
Cobb Vaughan 01,Vaughan 01,58,426,243,2,729
Cobb Vinings 01,Vinings 01,125,679,485,1,1290
Cobb Vinings 02,Vinings 02,243,1407,726,9,2385
Cobb Vinings 03,Vinings 03,204,1189,453,3,1849
Cobb Vinings 04,Vinings 04,134,547,348,6,1035
Cobb Wade Green 02,Wade Green 02,123,806,505,2,1436
Cobb Willeo 01,Willeo 01,102,563,274,0,939
Coffee Douglas,Douglas,188,1553,737,1,2479
Coffee Ambrose,Ambrose,10,101,78,0,189
Coffee Bridgetown,Bridgetown,3,10,31,0,44
Coffee Broxton,Broxton,17,132,133,2,284
Coffee Nicholls,Nicholls,15,72,106,0,193
Coffee West Green,West Green,2,10,15,0,27
Colquitt Shaw ,Shaw ,69,432,328,0,829
Colquitt Moultrie,Moultrie,88,501,287,0,876
Colquitt Autreyville,Autreyville,6,84,53,1,144
Colquitt Bridgecreek,Bridgecreek,12,37,18,0,67
Colquitt Crosland,Crosland,5,12,22,0,39
Colquitt Doerun,Doerun,3,24,76,0,103
Colquitt Funston,Funston,4,38,29,0,71
Colquitt Hamilton,Hamilton,1,15,17,0,33
Colquitt Hartsfield,Hartsfield,4,6,10,0,20
Colquitt Hopewell,Hopewell,8,68,38,1,115
Colquitt Lee,Lee,4,49,18,0,71
Colquitt Millcreek,Millcreek,0,12,14,0,26
Colquitt Monk,Monk,17,73,40,0,130
Colquitt Murphy,Murphy,8,42,17,0,67
Colquitt Norman Park,Norman Park,21,134,78,0,233
Colquitt Robinson,Robinson,4,29,35,0,68
Colquitt Thigpen,Thigpen,0,3,12,0,15
Colquitt TyTy,TyTy,2,8,9,0,19
Colquitt Warrior,Warrior,0,13,27,0,40
Columbia Kiokee Bapt Church,Kiokee Bapt Church,34,168,73,0,275
Columbia Stevens Creek Church-Grovetown,Stevens Creek Church-Grovetown,34,318,161,2,515
Columbia Lewis Methodist,Lewis Methodist,92,595,335,0,1022
Columbia Woodlawn Bapt Church,Woodlawn Bapt Church,29,121,72,0,222
Columbia Patriots Park,Patriots Park,35,333,120,0,488
Columbia New Life Church,New Life Church,19,118,47,0,184
Columbia Columbia Co. Health Dept.,Columbia Co. Health Dept.,65,679,399,0,1143
Columbia Harlem Branch Library,Harlem Branch Library,39,215,132,0,386
Columbia Harlem Senior Center,Harlem Senior Center,36,205,190,0,431
Columbia Second Mount Moriah Baptist Church,Second Mount Moriah Baptist Church,8,90,56,0,154
Columbia Bessie Thomas Center,Bessie Thomas Center,11,33,27,0,71
Columbia Philadelphia Church,Philadelphia Church,47,308,224,0,579
Columbia Liberty Park-Grovetown,Liberty Park-Grovetown,51,464,286,0,801
Columbia Grovetown Methodist,Grovetown Methodist,42,419,314,1,776
Columbia G A Apostolic Church,G A Apostolic Church,29,184,137,0,350
Columbia Grovetown Dept of Public Safety Station #2,Grovetown Dept of Public Safety Station #2,88,628,387,0,1103
Columbia Grove First Baptist Church,Grove First Baptist Church,63,588,314,0,965
Columbia Eubank/Blanchard Ctr,Eubank/Blanchard Ctr,21,86,92,0,199
Columbia Second Mt. Carmel Baptist Church,Second Mt. Carmel Baptist Church,20,81,124,0,225
Columbia Damascus Bapt Church,Damascus Bapt Church,11,32,49,0,92
Columbia Col Cty Board of Edu,Col Cty Board of Edu,40,256,126,0,422
Columbia Greenbrier High,Greenbrier High,57,374,224,1,656
Columbia Parkway Baptist Church,Parkway Baptist Church,36,386,203,0,625
Columbia Riverview Church,Riverview Church,31,166,92,0,289
Columbia Grace Baptist Church,Grace Baptist Church,51,594,284,0,929
Columbia Christ Sanctified,Christ Sanctified,41,248,180,0,469
Columbia Parkway Elementary,Parkway Elementary,45,304,148,0,497
Columbia Blanchard Park,Blanchard Park,45,227,144,2,418
Columbia Belair Baptist Church,Belair Baptist Church,35,295,203,0,533
Columbia Marvin Methodist,Marvin Methodist,43,153,166,0,362
Columbia Westside Bapt Church,Westside Bapt Church,42,142,119,0,303
Columbia Trinity Bapt Church,Trinity Bapt Church,38,208,145,0,391
Columbia Abilene Baptist,Abilene Baptist,42,152,147,0,341
Columbia Augusta Christian,Augusta Christian,38,212,194,0,444
Columbia Savannah Rapids Pavilion,Savannah Rapids Pavilion,39,162,64,0,265
Columbia Gospel Water Branch,Gospel Water Branch,47,314,211,0,572
Columbia ACS-Furys Ferry Rd Campus,ACS-Furys Ferry Rd Campus,53,211,115,0,379
Columbia Stevens Creek Church,Stevens Creek Church,59,324,197,0,580
Columbia Columbia Co. Fire HDQTR,Columbia Co. Fire HDQTR,28,102,95,0,225
Columbia Lakeside Middle,Lakeside Middle,21,162,144,1,328
Columbia Martinez Baptist,Martinez Baptist,29,163,180,0,372
Columbia Gold Cross EMS,Gold Cross EMS,65,134,78,0,277
Columbia Church of Our Savior,Church of Our Savior,61,205,193,0,459
Columbia West Acres Baptist,West Acres Baptist,63,245,137,0,445
Columbia Journey Comm Church,Journey Comm Church,29,136,55,0,220
Columbia Wesley Methodist,Wesley Methodist,31,290,144,0,465
Columbia Col Cty Main Library,Col Cty Main Library,39,279,126,0,444
Columbia Christ Church Presbyterian,Christ Church Presbyterian,24,212,139,0,375
Columbia Blueridge Elementary,Blueridge Elementary,28,258,167,0,453
Columbia Christ The King Church,Christ The King Church,59,248,139,0,446
Cook Cecil,Cecil,33,218,106,0,357
Cook Delle Beamguard,Delle Beamguard,33,167,97,0,297
Cook Elm Pine,Elm Pine,26,89,92,0,207
Cook Lenox,Lenox,16,44,72,0,132
Cook Massee,Massee,9,57,25,0,91
Cook New Life Baptist Church,New Life Baptist Church,8,51,30,0,89
Cook Riverbend,Riverbend,9,62,14,0,85
Cook Sparks,Sparks,20,101,118,0,239
Coweta Senoia,Senoia,96,581,367,0,1044
Coweta Moreland,Moreland,36,155,166,0,357
Coweta Pine Road,Pine Road,20,125,108,0,253
Coweta Dresden,Dresden,17,30,42,0,89
Coweta Newnan,Newnan,120,492,386,0,998
Coweta Sharpsburg,Sharpsburg,58,370,191,1,620
Coweta Fischer Road,Fischer Road,75,455,236,0,766
Coweta Grantville,Grantville,47,152,256,0,455
Coweta Haralson,Haralson,26,109,117,0,252
Coweta Welcome,Welcome,48,175,182,2,407
Coweta Panther Creek,Panther Creek,40,197,217,0,454
Coweta Raymond,Raymond,41,195,135,0,371
Coweta Turin,Turin,76,456,224,0,756
Coweta Smokey Road,Smokey Road,67,282,247,0,596
Coweta Central,Central,108,605,421,0,1134
Coweta Newnan Centre,Newnan Centre,467,3204,1419,2,5092
Coweta Greentop,Greentop,61,329,247,0,637
Coweta Expo Center,Expo Center,36,160,195,1,392
Coweta White Oak,White Oak,103,523,221,0,847
Coweta Madras,Madras,234,1238,598,1,2071
Coweta Cannongate,Cannongate,43,343,216,0,602
Coweta Westside,Westside,23,84,170,0,277
Coweta Northside,Northside,38,249,257,0,544
Coweta Thomas Crossroads,Thomas Crossroads,78,468,252,0,798
Coweta Coweta Central Library,Coweta Central Library,29,264,64,0,357
Crawford District 1,District 1,69,346,126,1,542
Crawford District 2,District 2,45,212,80,1,338
Crawford District 3,District 3,10,78,28,1,117
Crawford District 4,District 4,17,89,55,0,161
Crawford District 5,District 5,11,76,53,0,140
Crisp Arabi,Arabi,7,33,46,0,86
Crisp Coney,Coney,8,47,32,0,87
Crisp Cordele,Cordele,180,1111,582,0,1873
Crisp Jamestown,Jamestown,6,58,21,0,85
Crisp Listonia,Listonia,4,14,15,0,33
Dade South Dade,South Dade,5,51,53,0,109
Dade New Salem,New Salem,10,99,53,0,162
Dade Davis,Davis,5,37,40,0,82
Dade New Home,New Home,0,28,33,0,61
Dade West Brow,West Brow,12,64,74,0,150
Dade Trenton,Trenton,18,153,53,0,224
Dade North Dade,North Dade,20,115,73,0,208
Dawson West,West,70,297,107,0,474
Dawson Central,Central,62,551,161,0,774
Dawson East,East,104,644,280,1,1029
Decatur Mt. Pleasant,Mt. Pleasant,5,22,22,0,49
Decatur Recovery,Recovery,12,44,30,0,86
Decatur Kendrick,Kendrick,7,28,32,0,67
Decatur Climax,Climax,24,71,49,1,145
Decatur Brinson,Brinson,7,46,42,1,96
Decatur West Bainbridge,West Bainbridge,38,283,119,2,442
Decatur Bainbridge-Coliseum,Bainbridge-Coliseum,42,263,148,1,454
Decatur Bainbridge-Fairgrounds,Bainbridge-Fairgrounds,80,410,278,1,769
Decatur Attapulgus,Attapulgus,67,291,214,2,574
Decatur Kirbo Center,Kirbo Center,67,408,146,0,621
DeKalb Allgood Elem,Allgood Elem,90,858,367,1,1316
DeKalb Ashford Park Elem,Ashford Park Elem,45,575,338,1,959
DeKalb Austin,Austin,90,643,246,1,980
DeKalb Avondale,Avondale,170,1255,614,0,2039
DeKalb Austin Drive,Austin Drive,99,592,279,1,971
DeKalb Ashford Dunwoody Rd,Ashford Dunwoody Rd,132,752,366,0,1250
DeKalb Ashford Parkside,Ashford Parkside,135,842,404,0,1381
DeKalb Avondale High,Avondale High,171,1394,437,3,2005
DeKalb Boulevard,Boulevard,176,2357,696,0,3229
DeKalb Briar Vista Elem,Briar Vista Elem,135,956,365,3,1459
DeKalb Briarlake Elem,Briarlake Elem,94,518,276,0,888
DeKalb Briarwood,Briarwood,43,713,206,1,963
DeKalb Brockett Elem,Brockett Elem,109,718,285,0,1112
DeKalb Briarcliff,Briarcliff,185,771,396,1,1353
DeKalb Brockett,Brockett,76,705,365,1,1147
DeKalb Brookhaven,Brookhaven,86,842,408,0,1336
DeKalb Browns Mill Elem,Browns Mill Elem,116,1512,530,0,2158
DeKalb Bouldercrest Road,Bouldercrest Road,67,777,242,0,1086
DeKalb Bethune Middle,Bethune Middle,146,1471,461,0,2078
DeKalb Burgess Elem,Burgess Elem,138,1472,577,1,2188
DeKalb Columbia Drive,Columbia Drive,93,615,285,0,993
DeKalb Canby Lane Elem,Canby Lane Elem,85,579,268,1,933
DeKalb Columbia Elem,Columbia Elem,56,265,167,1,489
DeKalb Cedar Grove Elem,Cedar Grove Elem,134,1462,412,2,2010
DeKalb Chamblee,Chamblee,47,764,208,2,1021
DeKalb Candler-Murphey Candler Elem,Candler-Murphey Candler Elem,123,1303,474,1,1901
DeKalb Chapel Hill Elem,Chapel Hill Elem,112,1203,386,1,1702
DeKalb Chesnut Elem,Chesnut Elem,59,567,306,1,933
DeKalb Clairemont West,Clairemont West,272,1392,661,0,2325
DeKalb Clairmont Road,Clairmont Road,245,1052,410,0,1707
DeKalb Clarkston,Clarkston,44,615,436,2,1097
DeKalb Clifton,Clifton,78,543,190,0,811
DeKalb Columbia Middle,Columbia Middle,80,531,229,0,840
DeKalb Coan Recreation Center,Coan Recreation Center,166,1522,680,0,2368
DeKalb Cross Keys High,Cross Keys High,86,533,226,0,845
DeKalb Crossroads,Crossroads,93,953,292,1,1339
DeKalb Candler,Candler,115,1016,411,0,1542
DeKalb Cedar Grove Middle,Cedar Grove Middle,58,480,150,0,688
DeKalb Cedar Grove South,Cedar Grove South,106,1532,499,2,2139
DeKalb Covington Hwy,Covington Hwy,9,71,20,0,100
DeKalb Covington,Covington,56,637,203,1,897
DeKalb Clairemont East,Clairemont East,262,1429,468,0,2159
DeKalb Coralwood,Coralwood,238,1189,395,1,1823
DeKalb Candler Park,Candler Park,251,1997,689,0,2937
DeKalb Clarkston Community Center,Clarkston Community Center,55,541,294,1,891
DeKalb Chamblee 2,Chamblee 2,126,919,302,0,1347
DeKalb Doraville North,Doraville North,60,493,392,0,945
DeKalb Doraville South,Doraville South,29,254,187,1,471
DeKalb Dresden Elem,Dresden Elem,150,1011,603,2,1766
DeKalb Decatur,Decatur,90,865,395,0,1350
DeKalb Dunaire Elem,Dunaire Elem,98,609,305,0,1012
DeKalb Dunwoody,Dunwoody,101,833,321,0,1255
DeKalb Dunwoody 2,Dunwoody 2,74,586,144,0,804
DeKalb Druid Hills High,Druid Hills High,134,851,290,1,1276
DeKalb Dunwoody Library,Dunwoody Library,73,704,181,0,958
DeKalb East Lake,East Lake,222,1576,632,1,2431
DeKalb Embry Hills,Embry Hills,69,510,207,0,786
DeKalb Evansdale Elem,Evansdale Elem,130,852,420,0,1402
DeKalb Emory South,Emory South,166,1097,397,2,1662
DeKalb Emory Road,Emory Road,101,956,337,1,1395
DeKalb Fairington Elem,Fairington Elem,116,1063,606,2,1787
DeKalb Fernbank Elem,Fernbank Elem,162,876,369,0,1407
DeKalb Flat Shoals Elem,Flat Shoals Elem,102,658,248,0,1008
DeKalb Flat Shoals Parkway,Flat Shoals Parkway,141,1383,329,1,1854
DeKalb Flat Rock Elem,Flat Rock Elem,80,1129,436,1,1646
DeKalb Flat Shoals,Flat Shoals,126,683,197,0,1006
DeKalb Flakes Mill,Flakes Mill,72,781,172,3,1028
DeKalb Flat Shoals Library,Flat Shoals Library,60,713,310,1,1084
DeKalb Freedom Middle,Freedom Middle,88,860,311,0,1259
DeKalb Glennwood,Glennwood,188,968,509,1,1666
DeKalb Glenhaven,Glenhaven,63,498,216,0,777
DeKalb Gresham Road,Gresham Road,153,1189,413,1,1756
DeKalb Georgetown Sq,Georgetown Sq,86,856,352,0,1294
DeKalb Glenwood Road,Glenwood Road,71,513,263,0,847
DeKalb Hambrick Elem,Hambrick Elem,108,823,417,0,1348
DeKalb Hawthorne Elem,Hawthorne Elem,114,919,530,1,1564
DeKalb Henderson Mill,Henderson Mill,147,870,368,0,1385
DeKalb Huntley Hills Elem,Huntley Hills Elem,75,768,436,0,1279
DeKalb Hugh Howell,Hugh Howell,73,499,268,0,840
DeKalb Harris-Narvie J Harris Elem,Harris-Narvie J Harris Elem,136,1575,341,1,2053
DeKalb Harris-Margaret Harris ED,Harris-Margaret Harris ED,34,392,262,0,688
DeKalb Idlewood Elem,Idlewood Elem,67,602,283,1,953
DeKalb Indian Creek,Indian Creek,74,439,186,2,701
DeKalb Johnson Estates,Johnson Estates,113,692,177,0,982
DeKalb Jolly Elem,Jolly Elem,114,771,357,1,1243
DeKalb Kelley Lake Elem,Kelley Lake Elem,106,853,363,2,1324
DeKalb Kingsley Elem,Kingsley Elem,112,603,207,0,922
DeKalb Kelley Chapel Road,Kelley Chapel Road,70,521,173,0,764
DeKalb Knollwood,Knollwood,119,660,419,1,1199
DeKalb Kittredge Elem,Kittredge Elem,103,664,244,1,1012
DeKalb Lakeside High,Lakeside High,151,918,512,0,1581
DeKalb Lavista Road,Lavista Road,182,643,274,2,1101
DeKalb Lavista,Lavista,110,730,324,1,1165
DeKalb Lithonia,Lithonia,29,303,250,2,584
DeKalb Lin-Mary Lin Elem,Lin-Mary Lin Elem,191,1204,472,4,1871
DeKalb Lithonia High,Lithonia High,84,892,461,1,1438
DeKalb Livsey Elem,Livsey Elem,62,384,163,0,609
DeKalb Miller-Eldridge L Miller Elem,Miller-Eldridge L Miller Elem,137,1021,383,0,1541
DeKalb McNair High,McNair High,174,1510,505,0,2189
DeKalb Marbut Elem,Marbut Elem,105,1124,436,0,1665
DeKalb McNair,McNair,183,822,313,2,1320
DeKalb McLendon,McLendon,143,1068,450,0,1661
DeKalb McWilliams,McWilliams,92,969,318,1,1380
DeKalb Medlock,Medlock,154,906,501,1,1562
DeKalb Midvale Elem,Midvale Elem,104,791,297,0,1192
DeKalb Miller Grove,Miller Grove,119,1219,483,0,1821
DeKalb Montclair Elem,Montclair Elem,34,387,243,1,665
DeKalb Montreal,Montreal,60,666,376,0,1102
DeKalb Meadowview,Meadowview,222,1065,329,4,1620
DeKalb Memorial South,Memorial South,57,540,226,2,825
DeKalb Midway,Midway,123,878,258,0,1259
DeKalb McNair Academy,McNair Academy,88,680,273,0,1041
DeKalb Mount Vernon East,Mount Vernon East,81,678,260,0,1019
DeKalb Mathis-Bob Mathis Elem,Mathis-Bob Mathis Elem,148,1083,291,0,1522
DeKalb Mount Vernon West,Mount Vernon West,67,694,188,0,949
DeKalb Metropolitan,Metropolitan,109,1381,574,0,2064
DeKalb Montgomery Elem,Montgomery Elem,95,651,354,0,1100
DeKalb Miller Grove Road,Miller Grove Road,81,741,334,0,1156
DeKalb Midvale Road,Midvale Road,51,507,225,0,783
DeKalb Miller Grove High,Miller Grove High,80,830,337,1,1248
DeKalb North Decatur,North Decatur,101,584,245,0,930
DeKalb North Hairston,North Hairston,72,579,231,2,884
DeKalb Northlake,Northlake,87,458,282,0,827
DeKalb North Peachtree,North Peachtree,40,391,224,1,656
DeKalb Oak Grove Elem,Oak Grove Elem,129,667,352,0,1148
DeKalb Oakcliff Elem,Oakcliff Elem,47,254,276,0,577
DeKalb Oakhurst,Oakhurst,126,1137,518,0,1781
DeKalb Oak View Elem,Oak View Elem,121,1542,513,2,2178
DeKalb Peachcrest,Peachcrest,99,586,250,2,937
DeKalb Peachtree Middle,Peachtree Middle,102,847,329,0,1278
DeKalb Princeton Elem,Princeton Elem,55,809,291,1,1156
DeKalb Pine Lake,Pine Lake,7,98,261,0,366
DeKalb Pleasantdale Road,Pleasantdale Road,98,762,448,1,1309
DeKalb Ponce de Leon,Ponce de Leon,412,1012,510,0,1934
DeKalb Panola,Panola,64,544,143,1,752
DeKalb Panola Way Elem,Panola Way Elem,47,498,230,0,775
DeKalb Piney Grove,Piney Grove,93,591,284,0,968
DeKalb Panola Road,Panola Road,93,984,339,0,1416
DeKalb Rainbow Elem,Rainbow Elem,141,1360,349,2,1852
DeKalb Redan Elem,Redan Elem,94,1107,360,1,1562
DeKalb Rehoboth,Rehoboth,127,594,243,0,964
DeKalb Rockbridge Elem,Rockbridge Elem,94,689,367,0,1150
DeKalb Rock Chapel Elem,Rock Chapel Elem,70,934,408,0,1412
DeKalb Rowland Elem,Rowland Elem,109,912,369,1,1391
DeKalb Redan-Trotti Library,Redan-Trotti Library,137,1224,435,1,1797
DeKalb Rockbridge Road,Rockbridge Road,153,1595,472,1,2221
DeKalb Rowland Road,Rowland Road,57,632,276,0,965
DeKalb Redan Road,Redan Road,90,825,307,0,1222
DeKalb Rock Chapel Road,Rock Chapel Road,128,1692,398,0,2218
DeKalb Redan Middle,Redan Middle,94,853,258,1,1206
DeKalb Sagamore Hills Elem,Sagamore Hills Elem,180,1033,474,1,1688
DeKalb Scott,Scott,174,969,375,0,1518
DeKalb Shaw-Robert Shaw Elem,Shaw-Robert Shaw Elem,119,903,381,0,1403
DeKalb Stone Mountain Elem,Stone Mountain Elem,206,556,208,0,970
DeKalb Silver Lake,Silver Lake,154,1101,423,0,1678
DeKalb Skyland,Skyland,52,498,293,2,845
DeKalb Snapfinger Elem,Snapfinger Elem,111,674,267,0,1052
DeKalb Smoke Rise,Smoke Rise,97,652,214,1,964
DeKalb Stone Mtn Middle,Stone Mtn Middle,36,522,292,0,850
DeKalb Stone Mill Elem,Stone Mill Elem,65,514,357,1,937
DeKalb Shadow Rock Elem,Shadow Rock Elem,187,1708,443,1,2339
DeKalb Stoneview Elem,Stoneview Elem,59,385,210,1,655
DeKalb Salem Middle,Salem Middle,125,1509,460,0,2094
DeKalb Shamrock,Shamrock,80,544,314,0,938
DeKalb South Deshon,South Deshon,117,1077,415,1,1610
DeKalb Stone Mtn Champion,Stone Mtn Champion,67,681,358,3,1109
DeKalb Stone Mtn,Stone Mtn,48,348,211,0,607
DeKalb Snapfinger Road N,Snapfinger Road N,90,745,267,0,1102
DeKalb Snapfinger Road S,Snapfinger Road S,72,746,219,0,1037
DeKalb Stephenson Middle,Stephenson Middle,105,1353,414,0,1872
DeKalb South Hairston,South Hairston,105,964,435,1,1505
DeKalb Stephenson High,Stephenson High,130,1208,405,0,1743
DeKalb Stonecrest Library,Stonecrest Library,80,1511,465,2,2058
DeKalb Snapfinger Road,Snapfinger Road,229,2383,408,1,3021
DeKalb Terry Mill,Terry Mill,168,883,350,1,1402
DeKalb Toney Elem,Toney Elem,93,508,200,0,801
DeKalb Tucker Library,Tucker Library,122,1130,295,0,1547
DeKalb Tilly Mill Road,Tilly Mill Road,38,412,169,0,619
DeKalb Tucker,Tucker,113,930,285,1,1329
DeKalb Valley Brook,Valley Brook,37,249,266,0,552
DeKalb Wadsworth,Wadsworth,140,927,427,0,1494
DeKalb Wesley Chapel Library,Wesley Chapel Library,116,1304,235,2,1657
DeKalb Woodrow Road,Woodrow Road,67,963,344,0,1374
DeKalb Winnona Park,Winnona Park,123,919,434,0,1476
DeKalb Woodridge Elem,Woodridge Elem,167,1013,389,0,1569
DeKalb Warren Tech,Warren Tech,41,235,243,0,519
DeKalb Woodward,Woodward,126,912,372,0,1410
DeKalb White Oak,White Oak,54,611,365,0,1030
DeKalb Winters Chapel,Winters Chapel,43,348,197,0,588
DeKalb Wynbrooke Elem,Wynbrooke Elem,125,1397,455,2,1979
DeKalb Young Road,Young Road,75,808,147,1,1031
Dodge Chauncey,Chauncey,0,9,34,0,43
Dodge Clark,Clark,2,0,1,0,3
Dodge Eddin,Eddin,27,102,66,0,195
Dodge Empire,Empire,1,13,10,0,24
Dodge Jaybird,Jaybird,0,22,23,0,45
Dodge Jones,Jones,1,11,12,0,24
Dodge Lee,Lee,105,540,255,0,900
Dodge McCranie,McCranie,5,10,8,0,23
Dodge Milan,Milan,4,9,25,0,38
Dodge Mitchell,Mitchell,6,21,17,0,44
Dodge Mullis,Mullis,4,13,32,0,49
Dodge Plainfield,Plainfield,5,15,13,0,33
Dodge Pondtown,Pondtown,14,30,46,0,90
Dodge Rawlins,Rawlins,6,66,40,0,112
Dodge Vilula,Vilula,2,3,1,0,6
Dodge Yonker,Yonker,0,2,9,0,11
Dooly Lilly,Lilly,17,61,56,0,134
Dooly Byromville,Byromville,21,68,89,0,178
Dooly Unadilla,Unadilla,35,163,201,0,399
Dooly Vienna,Vienna,73,415,187,0,675
Dooly Pinehurst,Pinehurst,5,36,34,0,75
Dougherty Sherwood Elementary School,Sherwood Elementary School,57,416,389,0,862
Dougherty Covenant Church,Covenant Church,38,267,245,0,550
Dougherty Greenbriar Church,Greenbriar Church,77,815,407,0,1299
Dougherty Westover High School,Westover High School,121,959,538,0,1618
Dougherty Merry Acres Middle,Merry Acres Middle,42,332,293,0,667
Dougherty ASU West Campus,ASU West Campus,135,867,493,1,1496
Dougherty Westown Elementary School,Westown Elementary School,146,699,533,0,1378
Dougherty 2nd Mt. Zion Church,2nd Mt. Zion Church,32,164,165,0,361
Dougherty Mt. Zion Center ,Mt. Zion Center ,152,572,528,2,1254
Dougherty Alice Coachman Elementary,Alice Coachman Elementary,39,184,159,0,382
Dougherty Driskell Community Center,Driskell Community Center,43,173,260,0,476
Dougherty Shiloh Baptist Church,Shiloh Baptist Church,33,179,234,1,447
Dougherty Litman Cathedral,Litman Cathedral,44,211,251,0,506
Dougherty Phoebe Healthworks,Phoebe Healthworks,100,458,360,0,918
Dougherty Turner Elementary School,Turner Elementary School,14,64,77,0,155
Dougherty Robert H. Harvey Elementary,Robert H. Harvey Elementary,74,352,361,0,787
Dougherty Bill Miller Community Center,Bill Miller Community Center,46,341,312,0,699
Dougherty Radium Middle School,Radium Middle School,15,135,106,0,256
Dougherty Putney 1st Baptist Church,Putney 1st Baptist Church,43,347,327,1,718
Dougherty International Studies,International Studies,47,217,147,1,412
Dougherty Phoebe East ,Phoebe East ,68,352,353,2,775
Dougherty Pine Bluff Baptist Church,Pine Bluff Baptist Church,58,362,313,0,733
Dougherty Albany Middle School,Albany Middle School,68,266,289,1,624
Dougherty Christ Church,Christ Church,58,318,158,0,534
Dougherty Lamar Reese Elementary School,Lamar Reese Elementary School,57,255,221,0,533
Dougherty ASU East Campus - Lovett Hall ,ASU East Campus - Lovett Hall ,5,75,83,0,163
Douglas Mirror Lake Elementary,Mirror Lake Elementary,189,1205,706,0,2100
Douglas Winston,Winston,22,344,194,2,562
Douglas Dog River Library,Dog River Library,53,845,187,0,1085
Douglas Atlanta West Pentecostal,Atlanta West Pentecostal,78,764,412,0,1254
Douglas Ephesus Baptist Church,Ephesus Baptist Church,66,452,196,0,714
Douglas Prays Mill Gym,Prays Mill Gym,107,944,348,0,1399
Douglas Turner,Turner,77,706,309,1,1093
Douglas First Baptist Lithia Springs,First Baptist Lithia Springs,39,337,167,0,543
Douglas Lithia Springs High School,Lithia Springs High School,162,1855,618,0,2635
Douglas Deer Lick,Deer Lick,53,571,207,0,831
Douglas Golden Methodist Church,Golden Methodist Church,114,1419,653,0,2186
Douglas Old Courthouse,Old Courthouse,128,1124,423,1,1676
Douglas Beulah Baptist Church,Beulah Baptist Church,73,585,300,0,958
Douglas Stewart,Stewart,81,806,361,0,1248
Douglas Arbor Station,Arbor Station,58,544,348,0,950
Douglas Bright Star,Bright Star,57,339,216,0,612
Douglas Dorsett Shoals,Dorsett Shoals,75,498,279,0,852
Douglas Chapel Hill,Chapel Hill,125,1113,452,0,1690
Douglas Church At Chapel Hill,Church At Chapel Hill,126,1784,620,1,2531
Douglas Chestnut Log,Chestnut Log,108,1095,398,0,1601
Douglas St Julians Episcopal,St Julians Episcopal,67,336,211,0,614
Douglas Lutheran Church-GS,Lutheran Church-GS,130,1189,441,1,1761
Douglas First Baptist Douglasville,First Baptist Douglasville,83,710,214,0,1007
Douglas Factory Shoals,Factory Shoals,138,1612,481,2,2233
Douglas Boundary Waters,Boundary Waters,79,1463,481,0,2023
Early Arlington ,Arlington ,25,109,161,0,295
Early Blakely,Blakely,69,438,388,0,895
Early Cedar Springs ,Cedar Springs ,18,57,72,0,147
Early Cuba,Cuba,27,129,68,0,224
Early Urquhart,Urquhart,4,53,32,0,89
Echols Statenville,Statenville,2,74,24,0,100
Effingham 1A,1A,24,142,160,0,326
Effingham 1B,1B,18,138,84,0,240
Effingham 1C,1C,16,61,129,0,206
Effingham 1D,1D,25,53,100,0,178
Effingham 2A,2A,19,146,163,1,329
Effingham 2B,2B,14,108,84,0,206
Effingham 2C,2C,29,202,155,0,386
Effingham 2D,2D,48,232,206,0,486
Effingham 3A,3A,17,67,60,0,144
Effingham 3B,3B,38,164,175,0,377
Effingham 3C,3C,15,98,79,0,192
Effingham 3D,3D,39,244,232,0,515
Effingham 3E,3E,12,89,30,0,131
Effingham 4A,4A,43,282,144,0,469
Effingham 4B,4B,44,255,159,1,459
Effingham 4C,4C,22,169,83,1,275
Effingham 5A,5A,34,229,190,0,453
Effingham 5B,5B,22,139,125,1,287
Effingham 5C,5C,45,289,170,0,504
Effingham 5D,5D,23,134,153,0,310
Elbert Elberton,Elberton,99,517,277,0,893
Elbert Longstreet,Longstreet,9,56,29,1,95
Elbert Eliam,Eliam,9,41,32,2,84
Elbert Petersburg,Petersburg,3,17,19,0,39
Elbert Wyche,Wyche,14,105,59,0,178
Elbert Moss-Ruckersville,Moss-Ruckersville,17,38,27,0,82
Elbert Pike,Pike,58,184,69,3,314
Elbert Gaines,Gaines,4,26,28,0,58
Elbert Goshen,Goshen,21,69,75,0,165
Elbert Webbsboro,Webbsboro,2,31,40,0,73
Elbert Centerville,Centerville,11,39,44,2,96
Emanuel Adrian,Adrian,7,17,41,0,65
Emanuel Blundale,Blundale,0,12,13,0,25
Emanuel Canoochee,Canoochee,7,33,34,0,74
Emanuel Cross-Green,Cross-Green,5,19,72,0,96
Emanuel Garfiled,Garfiled,7,24,30,0,61
Emanuel Nunez,Nunez,4,17,21,0,42
Emanuel Oak Park,Oak Park,2,11,19,0,32
Emanuel Stillmore,Stillmore,4,32,66,0,102
Emanuel Summerton,Summerton,15,26,40,0,81
Emanuel Swainsboro,Swainsboro,117,751,419,0,1287
Emanuel Twin City,Twin City,31,120,141,0,292
Evans Veterans Community Center,Veterans Community Center,127,560,281,0,968
Fannin Colwell,Colwell,37,79,34,0,150
Fannin Fairplay,Fairplay,23,74,35,0,132
Fannin Flinthill,Flinthill,37,104,113,0,254
Fannin Hemptown,Hemptown,24,91,46,0,161
Fannin Hothouse,Hothouse,15,76,41,0,132
Fannin Mineral Bluff,Mineral Bluff,25,140,38,0,203
Fannin Mobile,Mobile,20,44,39,0,103
Fannin Morganton,Morganton,40,112,84,0,236
Fannin Noontootla,Noontootla,18,60,51,0,129
Fannin Skeniah,Skeniah,5,17,21,0,43
Fannin Sugar Creek,Sugar Creek,33,175,66,0,274
Fannin Toccoa,Toccoa,56,273,84,0,413
Fayette Blackrock,Blackrock,108,923,243,3,1277
Fayette Brooks,Brooks,25,157,99,0,281
Fayette Europe,Europe,140,1419,413,0,1972
Fayette Fayetteville East,Fayetteville East,68,520,168,0,756
Fayette Fayetteville West,Fayetteville West,78,509,176,1,764
Fayette Flint,Flint,35,518,198,0,751
Fayette Hopeful,Hopeful,56,614,264,1,935
Fayette Morning Creek,Morning Creek,101,876,293,1,1271
Fayette Rareover,Rareover,25,544,146,0,715
Fayette Sandy Creek,Sandy Creek,115,1374,439,0,1928
Fayette Shakerag East,Shakerag East,25,221,157,1,404
Fayette Shakerag West,Shakerag West,24,215,73,0,312
Fayette Starrs Mill,Starrs Mill,50,338,155,0,543
Fayette Whitewater,Whitewater,70,577,200,0,847
Fayette Woolsey,Woolsey,37,236,147,0,420
Fayette McIntosh,McIntosh,64,554,200,0,818
Fayette Oak Grove,Oak Grove,24,203,139,0,366
Fayette Kedron,Kedron,125,1078,418,4,1625
Fayette Aberdeen,Aberdeen,19,230,121,1,371
Fayette Windgate,Windgate,17,129,97,0,243
Fayette Flat Creek,Flat Creek,36,308,157,0,501
Fayette Braelinn,Braelinn,15,197,108,0,320
Fayette Kenwood,Kenwood,35,310,154,0,499
Fayette Banks,Banks,40,362,183,0,585
Fayette Harps Crossing,Harps Crossing,30,336,151,2,519
Fayette Willow Pond,Willow Pond,91,723,260,1,1075
Fayette Dogwood,Dogwood,66,608,231,0,905
Fayette Oak Ridge,Oak Ridge,71,568,228,0,867
Fayette Jeff Davis,Jeff Davis,63,698,234,1,996
Fayette Murphy,Murphy,85,740,305,0,1130
Fayette Fielding Ridge,Fielding Ridge,55,552,254,1,862
Fayette Willowbend,Willowbend,29,311,133,0,473
Fayette Camp Creek,Camp Creek,43,267,108,1,419
Fayette Rising Star,Rising Star,62,555,214,0,831
Fayette Spring Hill,Spring Hill,98,889,253,0,1240
Fayette Antioch,Antioch,38,278,146,1,463
Floyd Alto Park,Alto Park,63,256,184,0,503
Floyd Armuchee,Armuchee,11,68,84,0,163
Floyd Barkers,Barkers,25,111,61,0,197
Floyd Cave Spring,Cave Spring,13,71,110,1,195
Floyd Chulio,Chulio,13,50,56,3,122
Floyd Etowah,Etowah,75,406,182,0,663
Floyd Everett Springs,Everett Springs,0,13,25,0,38
Floyd Floyd Springs,Floyd Springs,10,65,56,0,131
Floyd Fosters Mill,Fosters Mill,4,38,34,0,76
Floyd Garden Lakes,Garden Lakes,23,179,87,1,290
Floyd Glenwood,Glenwood,43,188,179,0,410
Floyd Howell,Howell,6,39,61,0,106
Floyd East Lindale,East Lindale,37,253,139,0,429
Floyd Mt Alto North,Mt Alto North,77,616,289,4,986
Floyd Mt Alto South,Mt Alto South,66,415,335,1,817
Floyd North Carolina,North Carolina,15,92,68,0,175
Floyd Riverside,Riverside,7,57,71,0,135
Floyd East Rome,East Rome,84,605,317,2,1008
Floyd North Rome,North Rome,92,457,219,3,771
Floyd South Rome,South Rome,44,240,185,0,469
Floyd Texas Valley,Texas Valley,3,16,45,0,64
Floyd Vanns Valley,Vanns Valley,7,34,38,0,79
Floyd Watters,Watters,31,142,133,1,307
Floyd West Lindale,West Lindale,20,154,141,0,315
Floyd Town Rome,Town Rome,59,410,242,0,711
Forsyth 01 Big Creek,01 Big Creek,201,1417,658,2,2278
Forsyth 02 Brandywine,02 Brandywine,94,627,555,1,1277
Forsyth 04 Chestatee,04 Chestatee,43,285,116,0,444
Forsyth 05 Coal Mountain,05 Coal Mountain,79,600,375,1,1055
Forsyth 06 Crossroads,06 Crossroads,65,630,248,1,944
Forsyth 07 Cumming,07 Cumming,106,705,309,2,1122
Forsyth 08 Mashburn,08 Mashburn,139,731,301,0,1171
Forsyth 10 Midway,10 Midway,187,1387,499,0,2073
Forsyth 15 Heardsville,15 Heardsville,90,536,306,0,932
Forsyth 16 Otwell,16 Otwell,139,850,364,3,1356
Forsyth 19 Old Atlanta,19 Old Atlanta,85,358,399,1,843
Forsyth 21 South Forsyth,21 South Forsyth,52,437,235,0,724
Forsyth 25 Windermere,25 Windermere,133,1098,731,0,1962
Forsyth 27 Concord,27 Concord,123,989,457,0,1569
Forsyth 34 Fowler,34 Fowler,121,794,365,0,1280
Forsyth 35 Johns Creek,35 Johns Creek,223,1083,523,2,1831
Forsyth 36 Nichols,36 Nichols,133,1114,538,0,1785
Forsyth 38 Daves Creek,38 Daves Creek,171,1179,464,1,1815
Forsyth 39 Mathis,39 Mathis,85,536,246,2,869
Forsyth 40 West Forsyth,40 West Forsyth,101,978,354,1,1434
Forsyth 41 Grassland,41 Grassland,73,518,243,2,836
Forsyth 42 Keith Bridge,42 Keith Bridge,48,258,145,2,453
Forsyth 43 Lakeland,43 Lakeland,179,854,391,1,1425
Forsyth 44 Lanier,44 Lanier,60,341,122,0,523
Forsyth 45 Mountainside,45 Mountainside,67,509,182,1,759
Forsyth 46 Sawmill Branch,46 Sawmill Branch,77,570,253,3,903
Forsyth 47 Riverclub,47 Riverclub,39,232,214,0,485
Forsyth 49 Cheatam Creek,49 Cheatam Creek,68,462,174,0,704
Franklin Carnesville,Carnesville,7,88,47,0,142
Franklin West Franklin,West Franklin,7,50,43,0,100
Franklin Northeast Franklin,Northeast Franklin,25,124,94,0,243
Franklin Lavonia,Lavonia,34,108,118,0,260
Franklin Canon,Canon,10,39,33,0,82
Franklin Royston,Royston,21,89,92,0,202
Franklin Southwest Franklin,Southwest Franklin,17,81,39,0,137
Fulton 01A,01A,134,1483,758,1,2376
Fulton 01B,01B,136,1595,1209,2,2942
Fulton 01C,01C,33,339,224,2,598
Fulton 01D,01D,35,393,163,4,595
Fulton 01E,01E,114,1418,540,1,2073
Fulton 01F,01F,18,203,143,1,365
Fulton 01G,01G,46,718,354,3,1121
Fulton 01H,01H,37,182,102,1,322
Fulton 01I,01I,0,0,0,0,0
Fulton 01J,01J,55,601,363,1,1020
Fulton 01P,01P,28,183,277,0,488
Fulton 01R,01R,25,105,171,1,302
Fulton 01S,01S,36,405,273,1,715
Fulton 01T,01T,33,417,257,2,709
Fulton 02A,02A,146,1247,385,8,1786
Fulton 02A1,02A1,61,640,177,5,883
Fulton 02B,02B,59,526,312,1,898
Fulton 02C,02C,55,500,265,1,821
Fulton 02D,02D,129,1678,697,5,2509
Fulton 02E,02E,76,771,400,0,1247
Fulton 02F1,02F1,77,1123,411,1,1612
Fulton 02F2,02F2,20,209,93,0,322
Fulton 02G,02G,117,1358,568,4,2047
Fulton 02J,02J,83,792,300,1,1176
Fulton 02K,02K,57,507,210,1,775
Fulton 02L1,02L1,155,1558,534,1,2248
Fulton 02L1A,02L1A,75,585,374,2,1036
Fulton 02L2,02L2,57,734,246,4,1041
Fulton 02S,02S,18,206,120,0,344
Fulton 02W,02W,12,277,89,0,378
Fulton 03A,03A,32,357,235,0,624
Fulton 03B,03B,10,98,57,0,165
Fulton 03C,03C,38,407,160,1,606
Fulton 03D,03D,14,193,117,1,325
Fulton 03E,03E,43,388,387,1,819
Fulton 03F,03F,56,515,263,0,834
Fulton 03G,03G,7,103,91,0,201
Fulton 03H,03H,16,188,96,1,301
Fulton 03I,03I,14,345,123,1,483
Fulton 03L,03L,11,81,75,1,168
Fulton 03M,03M,16,207,268,0,491
Fulton 03N,03N,24,311,303,1,639
Fulton 03P1A,03P1A,90,1090,595,7,1782
Fulton 03P1B,03P1B,0,0,0,0,0
Fulton 03P2,03P2,4,25,9,0,38
Fulton 03S,03S,15,198,106,0,319
Fulton 03T,03T,24,339,209,3,575
Fulton 04A,04A,19,263,194,5,481
Fulton 04B,04B,28,312,197,3,540
Fulton 04C,04C,1,27,16,0,44
Fulton 04D,04D,36,439,229,0,704
Fulton 04F,04F,39,480,387,4,910
Fulton 04G,04G,15,181,128,0,324
Fulton 04I,04I,60,328,144,0,532
Fulton 04J,04J,2,78,119,11,210
Fulton 04K,04K,49,607,347,5,1008
Fulton 04L,04L,21,424,281,3,729
Fulton 04M,04M,15,130,116,2,263
Fulton 04S,04S,60,601,318,4,983
Fulton 04T,04T,32,295,214,1,542
Fulton 04V,04V,40,470,404,1,915
Fulton 04W,04W,2,75,96,1,174
Fulton 04X1,04X1,44,608,279,1,932
Fulton 04X2,04X2,13,202,82,0,297
Fulton 05A1,05A1,136,1295,590,0,2021
Fulton 05A2,05A2,87,1315,614,0,2016
Fulton 05B,05B,47,453,244,1,745
Fulton 05C,05C,3,12,9,0,24
Fulton 05D,05D,3,38,33,0,74
Fulton 05F,05F,1,14,14,0,29
Fulton 05J,05J,17,235,86,0,338
Fulton 05K,05K,48,462,309,1,820
Fulton 06B,06B,49,687,226,1,963
Fulton 06D,06D,111,922,429,5,1467
Fulton 06D1,06D1,214,1418,474,1,2107
Fulton 06D2,06D2,149,993,294,1,1437
Fulton 06E,06E,53,661,319,1,1034
Fulton 06F,06F,87,1126,284,0,1497
Fulton 06G,06G,23,200,57,0,280
Fulton 06I,06I,71,941,477,5,1494
Fulton 06J,06J,162,1110,357,2,1631
Fulton 06L1,06L1,64,383,108,0,555
Fulton 06L2,06L2,23,267,69,0,359
Fulton 06N,06N,58,472,191,2,723
Fulton 06Q,06Q,6,112,66,1,185
Fulton 06R,06R,82,756,136,2,976
Fulton 07A,07A,47,596,206,2,851
Fulton 07A1,07A1,157,1079,474,5,1715
Fulton 07B,07B,74,704,227,0,1005
Fulton 07C,07C,298,965,392,5,1660
Fulton 07D,07D,62,594,236,0,892
Fulton 07D1,07D1,34,445,197,0,676
Fulton 07E,07E,120,703,157,4,984
Fulton 07F,07F,88,914,358,2,1362
Fulton 07H,07H,84,620,176,1,881
Fulton 07J,07J,75,775,411,3,1264
Fulton 07M,07M,59,523,231,5,818
Fulton 07N,07N,51,465,184,3,703
Fulton 08A,08A,61,650,187,5,903
Fulton 08B,08B,95,908,263,2,1268
Fulton 08C,08C,4,55,12,0,71
Fulton 08C1,08C1,21,269,43,2,335
Fulton 08D,08D,23,234,53,0,310
Fulton 08E,08E,87,608,190,1,886
Fulton 08F1,08F1,58,526,145,1,730
Fulton 08F2,08F2,0,0,0,0,0
Fulton 08G,08G,139,665,180,1,985
Fulton 08H,08H,111,658,157,1,927
Fulton 08J,08J,87,828,337,6,1258
Fulton 08K,08K,24,245,124,0,393
Fulton 08L,08L,149,1316,439,1,1905
Fulton 08M,08M,55,502,202,3,762
Fulton 08N1,08N1,29,218,57,0,304
Fulton 08N2,08N2,79,447,105,1,632
Fulton 08P,08P,35,432,239,1,707
Fulton 09A,09A,89,1511,548,1,2149
Fulton 09B,09B,11,100,37,1,149
Fulton 09C,09C,75,876,327,3,1281
Fulton 09D,09D,60,414,261,1,736
Fulton 09E,09E,52,929,315,3,1299
Fulton 09F,09F,82,1075,358,4,1519
Fulton 09G,09G,81,1162,554,3,1800
Fulton 09H,09H,13,271,122,2,408
Fulton 09I,09I,36,299,147,2,484
Fulton 09K,09K,35,445,178,3,661
Fulton 09K1,09K1,47,643,246,5,941
Fulton 09M,09M,49,1087,273,1,1410
Fulton 10A,10A,76,952,392,4,1424
Fulton 10B,10B,139,1762,453,3,2357
Fulton 10C,10C,30,689,220,4,943
Fulton 10D,10D,6,149,89,1,245
Fulton 10D2,10D2,50,461,101,0,612
Fulton 10D1,10D1,56,547,163,2,768
Fulton 10E,10E,39,317,135,1,492
Fulton 10F,10F,42,306,159,1,508
Fulton 10G,10G,36,532,159,0,727
Fulton 10H1,10H1,17,154,37,1,209
Fulton 10H2,10H2,44,552,227,2,825
Fulton 10I,10I,15,196,25,0,236
Fulton 10J,10J,29,167,194,2,392
Fulton 10K,10K,40,613,184,3,840
Fulton 10M,10M,66,801,428,2,1297
Fulton 10P,10P,32,342,167,2,543
Fulton 10R,10R,9,150,110,3,272
Fulton 11B,11B,105,1082,297,4,1488
Fulton 11B2,11B2,3,41,13,0,57
Fulton 11B1,11B1,51,653,207,2,913
Fulton 11C,11C,9,163,23,0,195
Fulton 11C2,11C2,37,918,141,1,1097
Fulton 11C3,11C3,20,422,26,0,468
Fulton 11E1,11E1,19,366,137,0,522
Fulton 11E2,11E2,28,353,126,1,508
Fulton 11E3,11E3,34,1153,424,2,1613
Fulton 11G,11G,48,493,170,11,722
Fulton 11H,11H,21,221,78,0,320
Fulton 11J,11J,66,538,227,0,831
Fulton 11K,11K,60,765,189,0,1014
Fulton 11M,11M,25,481,155,0,661
Fulton 11M1,11M1,29,554,154,3,740
Fulton 11N,11N,67,892,251,1,1211
Fulton 11P,11P,76,527,160,1,764
Fulton 11R,11R,20,407,168,1,596
Fulton 12A,12A,38,718,223,4,983
Fulton 12A1,12A1,55,1099,437,3,1594
Fulton 12D,12D,20,279,157,0,456
Fulton 12E1,12E1,76,303,116,0,495
Fulton 12E2,12E2,0,0,0,0,0
Fulton 12F,12F,17,209,148,0,374
Fulton 12G,12G,33,217,74,0,324
Fulton 12H1,12H1,18,121,97,1,237
Fulton 12H2,12H2,68,662,421,2,1153
Fulton 12I,12I,25,252,78,0,355
Fulton 12J,12J,60,611,355,2,1028
Fulton 12K,12K,51,803,362,7,1223
Fulton 12L,12L,9,115,75,1,200
Fulton 12M,12M,48,519,435,2,1004
Fulton 12N,12N,11,189,119,2,321
Fulton 12S,12S,35,490,257,1,783
Fulton AP01A,AP01A,124,1147,410,3,1684
Fulton AP01B,AP01B,23,250,130,0,403
Fulton AP01C,AP01C,56,558,149,4,767
Fulton AP01D,AP01D,19,192,80,0,291
Fulton AP01E,AP01E,0,0,0,0,0
Fulton AP021,AP021,69,690,256,0,1015
Fulton AP022,AP022,64,373,158,0,595
Fulton AP023,AP023,31,181,46,0,258
Fulton AP02B,AP02B,39,157,37,1,234
Fulton AP03,AP03,10,83,82,0,175
Fulton AP04A,AP04A,35,392,108,1,536
Fulton AP04B,AP04B,7,123,36,0,166
Fulton AP05,AP05,138,993,361,0,1492
Fulton AP06,AP06,40,410,111,0,561
Fulton AP07A,AP07A,93,731,286,2,1112
Fulton AP07C,AP07C,20,167,77,1,265
Fulton AP07B,AP07B,23,193,102,0,318
Fulton AP09A,AP09A,115,969,368,1,1453
Fulton AP09B,AP09B,23,254,70,0,347
Fulton AP10,AP10,16,186,61,0,263
Fulton AP12A,AP12A,9,144,61,2,216
Fulton AP12B,AP12B,33,192,102,1,328
Fulton AP12C,AP12C,43,460,122,2,627
Fulton AP12D,AP12D,0,0,0,0,0
Fulton AP14,AP14,1,35,14,0,50
Fulton AP14A,AP14A,102,769,188,3,1062
Fulton CH01,CH01,2,91,14,0,107
Fulton CH02,CH02,7,138,30,0,175
Fulton CH03,CH03,4,54,23,2,83
Fulton CH04A,CH04A,11,257,57,2,327
Fulton CH04B,CH04B,0,3,0,0,3
Fulton CH05,CH05,3,54,25,0,82
Fulton CP011,CP011,35,395,105,1,536
Fulton CP012,CP012,37,545,116,1,699
Fulton CP01B,CP01B,8,146,35,1,190
Fulton CP02,CP02,43,365,101,0,509
Fulton CP04A,CP04A,0,1,0,0,1
Fulton CP04B,CP04B,0,13,0,0,13
Fulton CP051,CP051,0,17,12,0,29
Fulton CP05C,CP05C,28,493,208,0,729
Fulton CP052,CP052,0,0,0,0,0
Fulton CP05B,CP05B,1,28,16,0,45
Fulton CP06A,CP06A,3,68,44,0,115
Fulton CP06B,CP06B,1,1,0,0,2
Fulton CP07A,CP07A,2,74,38,2,116
Fulton CP07B,CP07B,0,3,2,0,5
Fulton CP07C,CP07C,0,30,19,0,49
Fulton CP07D,CP07D,1,24,17,0,42
Fulton CP07E,CP07E,0,10,10,0,20
Fulton CP07F,CP07F,0,18,14,0,32
Fulton CP081,CP081,3,36,25,1,65
Fulton CP083,CP083,0,22,17,0,39
Fulton CP084,CP084,0,0,0,0,0
Fulton CP08A,CP08A,4,40,42,1,87
Fulton EP01A,EP01A,41,886,298,2,1227
Fulton EP01B,EP01B,63,670,173,3,909
Fulton EP01C,EP01C,18,315,137,3,473
Fulton EP02A,EP02A,49,540,221,1,811
Fulton EP02B,EP02B,42,647,147,2,838
Fulton EP02C,EP02C,9,175,42,0,226
Fulton EP02D,EP02D,6,191,72,0,269
Fulton EP02E,EP02E,19,356,132,3,510
Fulton EP03A,EP03A,117,1555,465,3,2140
Fulton EP03B,EP03B,44,605,170,1,820
Fulton EP04A,EP04A,26,616,325,4,971
Fulton EP04B,EP04B,38,869,253,4,1164
Fulton EP04C,EP04C,65,875,211,2,1153
Fulton FA01A,FA01A,84,1367,337,5,1793
Fulton FA01B,FA01B,110,2185,545,8,2848
Fulton FA01C,FA01C,22,210,93,1,326
Fulton FA01D,FA01D,8,122,30,0,160
Fulton FC02,FC02,1,12,6,1,20
Fulton HP01,HP01,45,799,494,2,1340
Fulton JC01,JC01,113,921,332,3,1369
Fulton JC01A,JC01A,47,425,227,3,702
Fulton JC02,JC02,79,653,260,1,993
Fulton JC03A,JC03A,6,165,47,1,219
Fulton JC03B,JC03B,24,355,164,2,545
Fulton JC04A,JC04A,82,871,193,1,1147
Fulton JC04B,JC04B,10,82,22,2,116
Fulton JC04C,JC04C,26,351,98,1,476
Fulton JC05,JC05,30,552,192,0,774
Fulton JC06,JC06,67,471,224,0,762
Fulton JC07,JC07,134,1065,342,3,1544
Fulton JC08,JC08,59,723,244,4,1030
Fulton JC09,JC09,76,795,271,1,1143
Fulton JC10,JC10,87,595,200,0,882
Fulton JC11,JC11,56,662,226,1,945
Fulton JC12,JC12,69,535,93,1,698
Fulton JC13A,JC13A,54,426,136,1,617
Fulton JC13B,JC13B,1,38,21,0,60
Fulton JC14,JC14,58,577,133,0,768
Fulton JC15,JC15,19,192,67,0,278
Fulton JC16,JC16,56,676,218,0,950
Fulton JC18,JC18,68,648,197,0,913
Fulton JC19A,JC19A,58,729,173,1,961
Fulton JC19,JC19,43,337,111,1,492
Fulton ML01A,ML01A,39,606,189,2,836
Fulton ML01B,ML01B,5,124,30,1,160
Fulton ML01C,ML01C,4,24,6,0,34
Fulton ML02A,ML02A,58,333,148,0,539
Fulton ML02B,ML02B,34,336,83,0,453
Fulton ML03,ML03,59,555,196,1,811
Fulton ML03A,ML03A,10,85,15,0,110
Fulton ML04,ML04,59,614,189,1,863
Fulton ML05,ML05,100,992,350,4,1446
Fulton ML06A,ML06A,45,404,196,2,647
Fulton ML06B,ML06B,58,701,272,3,1034
Fulton ML07A,ML07A,9,124,64,1,198
Fulton ML07B,ML07B,24,259,104,0,387
Fulton MP01,MP01,10,32,134,0,176
Fulton PA01,PA01,42,872,239,1,1154
Fulton RW01,RW01,148,1058,364,4,1574
Fulton RW02,RW02,90,960,375,2,1427
Fulton RW03,RW03,18,94,47,0,159
Fulton RW03B,RW03B,38,414,170,2,624
Fulton RW03A,RW03A,19,161,55,0,235
Fulton RW03C,RW03C,26,389,172,4,591
Fulton RW04,RW04,53,538,132,0,723
Fulton RW05,RW05,39,394,225,0,658
Fulton RW05A,RW05A,19,164,92,0,275
Fulton RW06,RW06,53,736,292,0,1081
Fulton RW07A,RW07A,20,233,196,0,449
Fulton RW07B,RW07B,7,59,68,0,134
Fulton RW08,RW08,87,468,198,1,754
Fulton RW09,RW09,113,731,281,1,1126
Fulton RW09A,RW09A,55,474,167,1,697
Fulton RW10,RW10,73,506,222,0,801
Fulton RW10A,RW10A,29,243,52,0,324
Fulton RW11A,RW11A,66,646,231,1,944
Fulton RW11B,RW11B,0,0,0,0,0
Fulton RW12,RW12,59,611,292,0,962
Fulton RW12A,RW12A,78,725,263,1,1067
Fulton RW13,RW13,62,863,337,0,1262
Fulton RW16,RW16,54,477,168,1,700
Fulton RW17,RW17,55,741,324,0,1120
Fulton RW19,RW19,58,429,183,0,670
Fulton RW20,RW20,41,770,183,1,995
Fulton RW21,RW21,5,24,2,1,32
Fulton RW21A,RW21A,63,684,177,2,926
Fulton RW22A,RW22A,74,1026,386,2,1488
Fulton RW22C,RW22C,0,0,0,0,0
Fulton RW22B,RW22B,0,0,0,0,0
Fulton SC01A,SC01A,0,14,3,0,17
Fulton SC01B,SC01B,50,1105,223,0,1378
Fulton SC01C,SC01C,67,1293,166,0,1526
Fulton SC02,SC02,16,409,29,0,454
Fulton SC02A,SC02A,13,399,51,0,463
Fulton SC04,SC04,9,319,94,0,422
Fulton SC05A,SC05A,16,269,71,0,356
Fulton SC05B,SC05B,21,526,95,7,649
Fulton SC05C,SC05C,38,1135,250,1,1424
Fulton SC05D,SC05D,48,1333,291,3,1675
Fulton SC05E,SC05E,20,245,58,0,323
Fulton SC07A,SC07A,112,1644,327,4,2087
Fulton SC07B,SC07B,0,1,0,0,1
Fulton SC07C,SC07C,0,5,0,0,5
Fulton SC07D,SC07D,10,347,81,2,440
Fulton SC07E,SC07E,49,663,140,3,855
Fulton SC08A,SC08A,0,3,0,0,3
Fulton SC08J,SC08J,2,12,4,0,18
Fulton SC08B,SC08B,78,1474,378,1,1931
Fulton SC08I,SC08I,4,54,16,0,74
Fulton SC08C,SC08C,2,43,6,0,51
Fulton SC08D,SC08D,13,213,50,0,276
Fulton SC08E,SC08E,4,238,95,2,339
Fulton SC08F,SC08F,9,251,51,0,311
Fulton SC08G,SC08G,0,2,0,0,2
Fulton SC08H,SC08H,0,0,0,0,0
Fulton SC09A,SC09A,34,531,142,0,707
Fulton SC09B,SC09B,69,742,174,1,986
Fulton SC09C,SC09C,55,579,166,3,803
Fulton SC10,SC10,27,343,160,6,536
Fulton SC11A,SC11A,36,578,163,0,777
Fulton SC11B,SC11B,63,618,182,4,867
Fulton SC13,SC13,36,845,170,0,1051
Fulton SC13A,SC13A,23,400,87,1,511
Fulton SC14A,SC14A,18,311,63,1,393
Fulton SC15,SC15,84,1412,385,2,1883
Fulton SC15A,SC15A,58,1550,338,3,1949
Fulton SC16A,SC16A,49,1189,265,3,1506
Fulton SC16B,SC16B,60,1068,228,6,1362
Fulton SC17A,SC17A,1,26,7,0,34
Fulton SC17B,SC17B,0,0,0,0,0
Fulton SC17C,SC17C,13,499,101,0,613
Fulton SC18A,SC18A,28,229,40,0,297
Fulton SC18B,SC18B,35,615,119,3,772
Fulton SC18C,SC18C,42,907,126,2,1077
Fulton SC18D,SC18D,3,183,24,1,211
Fulton SC19A,SC19A,3,93,13,0,109
Fulton SC19B,SC19B,33,419,151,0,603
Fulton SC20,SC20,62,1431,183,2,1678
Fulton SC211,SC211,33,723,221,0,977
Fulton SC212,SC212,87,1485,462,3,2037
Fulton SC21A,SC21A,0,0,0,0,0
Fulton SC23A,SC23A,94,1155,447,0,1696
Fulton SC23B,SC23B,19,183,61,2,265
Fulton SC23C,SC23C,52,766,278,2,1098
Fulton SC27,SC27,72,869,183,0,1124
Fulton SC29A,SC29A,72,971,334,3,1380
Fulton SC29B,SC29B,0,0,0,1,1
Fulton SC30A,SC30A,19,73,10,0,102
Fulton SC30B,SC30B,22,337,72,2,433
Fulton SC31,SC31,3,148,36,0,187
Fulton SC32,SC32,2,5,4,0,11
Fulton SC33,SC33,1,8,0,0,9
Fulton SS01,SS01,108,835,242,0,1185
Fulton SS01A,SS01A,37,282,47,0,366
Fulton SS02A,SS02A,35,319,103,1,458
Fulton SS02B,SS02B,18,370,109,2,499
Fulton SS03A,SS03A,16,200,93,0,309
Fulton SS03,SS03,29,179,63,1,272
Fulton SS04A,SS04A,3,48,17,0,68
Fulton SS04,SS04,91,872,321,2,1286
Fulton SS05,SS05,52,521,164,1,738
Fulton SS06,SS06,55,452,121,0,628
Fulton SS07A,SS07A,50,348,43,0,441
Fulton SS07B,SS07B,20,240,83,0,343
Fulton SS07C,SS07C,33,161,47,0,241
Fulton SS07D,SS07D,0,0,0,0,0
Fulton SS08A,SS08A,40,334,256,1,631
Fulton SS08B,SS08B,22,184,54,2,262
Fulton SS08E,SS08E,10,90,28,0,128
Fulton SS08C,SS08C,9,187,61,0,257
Fulton SS08D,SS08D,39,375,137,2,553
Fulton SS09A,SS09A,123,757,168,0,1048
Fulton SS09B,SS09B,138,965,187,2,1292
Fulton SS11A,SS11A,85,851,353,6,1295
Fulton SS11B,SS11B,34,292,132,2,460
Fulton SS11C,SS11C,1,91,49,1,142
Fulton SS11D,SS11D,14,105,24,0,143
Fulton SS12,SS12,104,651,225,1,981
Fulton SS13A,SS13A,41,460,214,1,716
Fulton SS13B,SS13B,31,276,121,2,430
Fulton SS14,SS14,28,301,116,1,446
Fulton SS15A,SS15A,29,486,264,2,781
Fulton SS15B,SS15B,28,321,204,0,553
Fulton SS16,SS16,62,526,168,1,757
Fulton SS17,SS17,91,712,304,1,1108
Fulton SS18A,SS18A,15,104,22,0,141
Fulton SS18C,SS18C,11,67,19,0,97
Fulton SS18B,SS18B,10,66,21,0,97
Fulton SS19A,SS19A,44,729,304,1,1078
Fulton SS19B,SS19B,39,605,145,0,789
Fulton SS20,SS20,41,531,180,2,754
Fulton SS22,SS22,92,526,162,1,781
Fulton SS26,SS26,46,788,354,6,1194
Fulton SS29A,SS29A,85,677,257,4,1023
Fulton SS29B,SS29B,0,0,0,1,1
Fulton SS31,SS31,56,488,140,1,685
Fulton UC01A,UC01A,55,929,321,6,1311
Fulton UC01B,UC01B,3,86,45,0,134
Fulton UC01C,UC01C,0,1,0,0,1
Fulton UC01D,UC01D,0,0,0,0,0
Fulton UC01E,UC01E,13,230,68,1,312
Fulton UC02A,UC02A,42,229,54,2,327
Fulton UC02E,UC02E,81,1566,434,2,2083
Fulton UC02B,UC02B,0,7,4,0,11
Fulton UC02C,UC02C,3,21,18,0,42
Fulton UC02D,UC02D,66,1337,330,10,1743
Fulton UC031,UC031,73,693,249,3,1018
Fulton UC032,UC032,17,135,50,0,202
Fulton UC033,UC033,0,0,0,0,0
Fulton UC035,UC035,0,2,0,0,2
Gilmer Ellijay South,Ellijay South,60,237,102,0,399
Gilmer Cartecay,Cartecay,23,81,46,0,150
Gilmer Tails Creek,Tails Creek,11,62,60,0,133
Gilmer Town Creek,Town Creek,16,32,57,0,105
Gilmer Leaches,Leaches,39,228,80,0,347
Gilmer Cherry Log,Cherry Log,16,74,61,0,151
Gilmer Boardtown,Boardtown,25,110,53,0,188
Gilmer Mountaintown,Mountaintown,16,72,60,0,148
Gilmer East Ellijay,East Ellijay,26,109,45,0,180
Gilmer Ellijay North,Ellijay North,15,98,56,1,170
Gilmer Yukon,Yukon,10,69,46,0,125
Gilmer Roy Road,Roy Road,28,106,51,0,185
Gilmer Ellijay Northeast,Ellijay Northeast,32,162,48,0,242
Glascock Edgehill,Edgehill,2,5,4,0,11
Glascock Gibson,Gibson,4,21,18,0,43
Glascock Mill,Mill,1,19,7,0,27
Glascock Mitchell,Mitchell,3,4,25,0,32
Glynn SES,SES,74,399,147,1,621
Glynn BRK,BRK,44,322,150,0,516
Glynn MAR,MAR,36,273,165,0,474
Glynn BLY,BLY,22,138,67,1,228
Glynn NSSI,NSSI,90,727,182,0,999
Glynn CSSI,CSSI,124,957,208,0,1289
Glynn SSSI,SSSI,78,740,130,0,948
Glynn JI,JI,30,79,150,0,259
Glynn COG,COG,60,370,181,1,612
Glynn SEB,SEB,17,163,89,1,270
Glynn GICCA,GICCA,57,254,163,0,474
Glynn NGLY,NGLY,70,345,154,1,570
Glynn BAL,BAL,50,311,140,0,501
Glynn NSB,NSB,102,481,264,0,847
Glynn THE,THE,78,378,170,0,626
Glynn CPM,CPM,75,317,167,0,559
Glynn HCP,HCP,78,508,232,3,821
Glynn UPP,UPP,144,549,274,0,967
Glynn ARCO,ARCO,33,124,73,1,231
Gordon Sugar Valley,Sugar Valley,3,41,42,0,86
Gordon Plainville,Plainville,18,68,73,2,161
Gordon Sonoraville,Sonoraville,29,186,199,0,414
Gordon Pine Chapel,Pine Chapel,11,27,32,0,70
Gordon Oostanaula,Oostanaula,5,35,37,0,77
Gordon Oakman,Oakman,2,37,51,0,90
Gordon Gordon County,Gordon County,43,290,213,1,547
Gordon Calhoun City,Calhoun City,93,764,415,1,1273
Gordon Lily Pond,Lily Pond,16,75,69,0,160
Gordon Fairmount,Fairmount,9,44,73,0,126
Gordon Red Bud,Red Bud,21,125,117,0,263
Gordon Resaca,Resaca,8,28,54,0,90
Grady Blowing Cave,Blowing Cave,5,30,26,0,61
Grady Cairo 4th District,Cairo 4th District,96,530,255,1,882
Grady Cairo 5th District,Cairo 5th District,40,299,160,0,499
Grady Duncanville ,Duncanville ,14,58,22,0,94
Grady Higdon,Higdon,15,63,82,0,160
Grady Limesink,Limesink,3,26,5,0,34
Grady Midway,Midway,14,106,48,0,168
Grady Pine Park ,Pine Park ,11,65,67,0,143
Grady Ragan,Ragan,8,47,30,0,85
Grady Spence,Spence,4,21,17,0,42
Grady Spring Hill,Spring Hill,8,18,15,0,41
Grady Whigham,Whigham,16,80,61,0,157
Grady Woodland,Woodland,23,137,47,0,207
Greene Greensboro,Greensboro,137,713,350,0,1200
Greene Union Point,Union Point,50,203,257,0,510
Greene Siloam,Siloam,18,99,143,0,260
Greene White Plains,White Plains,13,51,45,0,109
Greene Old Salem,Old Salem,172,1045,231,0,1448
Gwinnett HARBINS A,HARBINS A,137,1556,631,1,2325
Gwinnett ROCKBRIDGE A,ROCKBRIDGE A,107,1096,418,3,1624
Gwinnett DACULA,DACULA,120,989,372,4,1485
Gwinnett SUWANEE A,SUWANEE A,33,371,181,1,586
Gwinnett BAYCREEK A,BAYCREEK A,70,484,295,1,850
Gwinnett GOODWINS A,GOODWINS A,112,633,424,1,1170
Gwinnett DULUTH A,DULUTH A,183,1136,457,1,1777
Gwinnett DUNCANS A,DUNCANS A,112,762,296,1,1171
Gwinnett PUCKETTS A,PUCKETTS A,91,891,304,0,1286
Gwinnett CATES A,CATES A,67,450,149,0,666
Gwinnett BERKSHIRE A,BERKSHIRE A,65,396,278,1,740
Gwinnett BERKSHIRE B,BERKSHIRE B,114,1085,440,1,1640
Gwinnett DUNCANS C,DUNCANS C,50,402,223,1,676
Gwinnett GARNERS A,GARNERS A,81,753,315,0,1149
Gwinnett LAWRENCEVILLE A,LAWRENCEVILLE A,116,650,349,0,1115
Gwinnett LAWRENCEVILLE B,LAWRENCEVILLE B,152,1142,454,0,1748
Gwinnett MARTINS A,MARTINS A,80,493,382,2,957
Gwinnett MARTINS B,MARTINS B,48,447,381,0,876
Gwinnett MARTINS C,MARTINS C,68,427,325,0,820
Gwinnett PINCKNEYVILLE A,PINCKNEYVILLE A,57,412,334,1,804
Gwinnett PINCKNEYVILLE B,PINCKNEYVILLE B,64,589,305,2,960
Gwinnett PINCKNEYVILLE C,PINCKNEYVILLE C,81,418,252,0,751
Gwinnett PINCKNEYVILLE D,PINCKNEYVILLE D,26,307,212,1,546
Gwinnett SUGAR HILL A,SUGAR HILL A,70,553,292,1,916
Gwinnett SUGAR HILL B,SUGAR HILL B,105,797,550,1,1453
Gwinnett HOG MOUNTAIN A,HOG MOUNTAIN A,121,824,527,2,1474
Gwinnett HOG MOUNTAIN B,HOG MOUNTAIN B,114,753,413,1,1281
Gwinnett ROCKYCREEK A,ROCKYCREEK A,104,1128,469,4,1705
Gwinnett CATES B,CATES B,25,245,163,1,434
Gwinnett CATES C,CATES C,61,658,297,0,1016
Gwinnett HOG MOUNTAIN D,HOG MOUNTAIN D,86,436,251,0,773
Gwinnett BERKSHIRE D,BERKSHIRE D,73,576,269,0,918
Gwinnett BERKSHIRE E,BERKSHIRE E,51,384,187,0,622
Gwinnett BERKSHIRE F,BERKSHIRE F,50,276,234,0,560
Gwinnett CATES D,CATES D,100,713,447,0,1260
Gwinnett CATES E,CATES E,103,661,281,1,1046
Gwinnett PINCKNEYVILLE E,PINCKNEYVILLE E,29,301,258,1,589
Gwinnett PINCKNEYVILLE F,PINCKNEYVILLE F,50,384,326,0,760
Gwinnett DUNCANS D,DUNCANS D,183,941,464,2,1590
Gwinnett PINCKNEYVILLE H,PINCKNEYVILLE H,141,1100,365,0,1606
Gwinnett BAYCREEK B,BAYCREEK B,148,1412,716,1,2277
Gwinnett LAWRENCEVILLE C,LAWRENCEVILLE C,63,405,259,0,727
Gwinnett MARTINS D,MARTINS D,53,332,254,0,639
Gwinnett ROCKBRIDGE B,ROCKBRIDGE B,96,968,404,0,1468
Gwinnett GARNERS B,GARNERS B,89,803,327,1,1220
Gwinnett CATES F,CATES F,53,232,188,0,473
Gwinnett CATES G,CATES G,95,527,315,1,938
Gwinnett DULUTH B,DULUTH B,104,552,258,2,916
Gwinnett GARNERS C,GARNERS C,37,378,211,0,626
Gwinnett PINCKNEYVILLE I,PINCKNEYVILLE I,39,352,220,2,613
Gwinnett PINCKNEYVILLE J,PINCKNEYVILLE J,35,375,231,0,641
Gwinnett BERKSHIRE G,BERKSHIRE G,32,554,178,1,765
Gwinnett CATES H,CATES H,73,804,397,1,1275
Gwinnett SUGAR HILL C,SUGAR HILL C,80,696,431,0,1207
Gwinnett SUGAR HILL D,SUGAR HILL D,90,681,276,0,1047
Gwinnett DULUTH C,DULUTH C,62,397,191,0,650
Gwinnett DULUTH D,DULUTH D,115,942,391,3,1451
Gwinnett PINCKNEYVILLE K,PINCKNEYVILLE K,48,534,334,2,918
Gwinnett PINCKNEYVILLE N,PINCKNEYVILLE N,49,702,484,0,1235
Gwinnett LAWRENCEVILLE D,LAWRENCEVILLE D,69,869,405,5,1348
Gwinnett LAWRENCEVILLE E,LAWRENCEVILLE E,77,361,182,1,621
Gwinnett PINCKNEYVILLE L,PINCKNEYVILLE L,90,429,221,0,740
Gwinnett PINCKNEYVILLE M,PINCKNEYVILLE M,83,434,244,0,761
Gwinnett GARNERS D,GARNERS D,102,908,366,1,1377
Gwinnett BERKSHIRE H,BERKSHIRE H,31,283,166,0,480
Gwinnett PINCKNEYVILLE O,PINCKNEYVILLE O,47,553,317,0,917
Gwinnett PUCKETTS E,PUCKETTS E,117,1030,427,2,1576
Gwinnett CATES I,CATES I,97,675,434,0,1206
Gwinnett CATES J,CATES J,76,694,394,0,1164
Gwinnett GOODWINS B,GOODWINS B,88,585,379,0,1052
Gwinnett LAWRENCEVILLE F,LAWRENCEVILLE F,92,987,339,1,1419
Gwinnett MARTINS E,MARTINS E,115,864,539,6,1524
Gwinnett PINCKNEYVILLE P,PINCKNEYVILLE P,69,399,219,1,688
Gwinnett PINCKNEYVILLE Q,PINCKNEYVILLE Q,28,262,268,0,558
Gwinnett ROCKBRIDGE C,ROCKBRIDGE C,154,1625,510,0,2289
Gwinnett ROCKBRIDGE D,ROCKBRIDGE D,98,1114,352,0,1564
Gwinnett GOODWINS C,GOODWINS C,163,917,559,1,1640
Gwinnett BAYCREEK K,BAYCREEK K,92,830,399,0,1321
Gwinnett CATES K,CATES K,66,461,336,0,863
Gwinnett BAYCREEK C,BAYCREEK C,156,1506,749,2,2413
Gwinnett CATES L,CATES L,104,885,404,0,1393
Gwinnett DULUTH E,DULUTH E,108,1040,507,2,1657
Gwinnett GOODWINS D,GOODWINS D,95,559,476,0,1130
Gwinnett LAWRENCEVILLE G,LAWRENCEVILLE G,72,509,372,1,954
Gwinnett LAWRENCEVILLE H,LAWRENCEVILLE H,117,723,358,1,1199
Gwinnett MARTINS F,MARTINS F,41,388,273,0,702
Gwinnett PINCKNEYVILLE S,PINCKNEYVILLE S,84,500,366,1,951
Gwinnett ROCKBRIDGE E,ROCKBRIDGE E,114,999,512,1,1626
Gwinnett SUGAR HILL E,SUGAR HILL E,92,592,260,2,946
Gwinnett LAWRENCEVILLE I,LAWRENCEVILLE I,76,567,341,1,985
Gwinnett BAYCREEK D,BAYCREEK D,126,978,480,4,1588
Gwinnett BERKSHIRE J,BERKSHIRE J,56,547,278,0,881
Gwinnett CATES M,CATES M,110,729,433,0,1272
Gwinnett CATES N,CATES N,54,364,224,0,642
Gwinnett DULUTH F,DULUTH F,130,1114,536,4,1784
Gwinnett DULUTH G,DULUTH G,78,500,244,0,822
Gwinnett GOODWINS E,GOODWINS E,123,902,506,1,1532
Gwinnett GOODWINS F,GOODWINS F,80,545,288,0,913
Gwinnett PINCKNEYVILLE T,PINCKNEYVILLE T,68,511,372,0,951
Gwinnett SUWANEE B,SUWANEE B,98,974,270,1,1343
Gwinnett PINCKNEYVILLE U,PINCKNEYVILLE U,47,342,288,0,677
Gwinnett PUCKETTS B,PUCKETTS B,53,400,177,0,630
Gwinnett BERKSHIRE L,BERKSHIRE L,64,457,340,1,862
Gwinnett ROCKBRIDGE F,ROCKBRIDGE F,130,1871,539,0,2540
Gwinnett SUGAR HILL F,SUGAR HILL F,78,554,386,0,1018
Gwinnett SUWANEE C,SUWANEE C,153,1011,435,3,1602
Gwinnett CATES O,CATES O,30,232,142,0,404
Gwinnett BAYCREEK E,BAYCREEK E,112,703,425,2,1242
Gwinnett BERKSHIRE M,BERKSHIRE M,35,347,190,1,573
Gwinnett MARTINS G,MARTINS G,35,308,283,0,626
Gwinnett DULUTH H,DULUTH H,104,515,243,0,862
Gwinnett BERKSHIRE N,BERKSHIRE N,103,735,237,0,1075
Gwinnett PINCKNEYVILLE V,PINCKNEYVILLE V,29,291,167,0,487
Gwinnett PINCKNEYVILLE W,PINCKNEYVILLE W,84,723,395,0,1202
Gwinnett MARTINS H,MARTINS H,128,718,506,0,1352
Gwinnett MARTINS I,MARTINS I,76,568,383,0,1027
Gwinnett MARTINS J,MARTINS J,57,591,461,0,1109
Gwinnett GARNERS F,GARNERS F,41,359,156,0,556
Gwinnett BERKSHIRE O,BERKSHIRE O,64,414,266,0,744
Gwinnett BERKSHIRE P,BERKSHIRE P,34,196,145,1,376
Gwinnett PINCKNEYVILLE X,PINCKNEYVILLE X,131,824,258,1,1214
Gwinnett ROCKBRIDGE G,ROCKBRIDGE G,166,1660,589,3,2418
Gwinnett PINCKNEYVILLE Y,PINCKNEYVILLE Y,42,431,300,1,774
Gwinnett GOODWINS G,GOODWINS G,55,403,337,0,795
Gwinnett PINCKNEYVILLE Z,PINCKNEYVILLE Z,68,311,226,0,605
Gwinnett PINCKNEYVILLE A1,PINCKNEYVILLE A1,103,536,255,0,894
Gwinnett LAWRENCEVILLE J,LAWRENCEVILLE J,63,439,269,0,771
Gwinnett GOODWINS H,GOODWINS H,62,450,322,1,835
Gwinnett DUNCANS B,DUNCANS B,111,806,466,1,1384
Gwinnett SUWANEE D,SUWANEE D,109,713,383,3,1208
Gwinnett SUWANEE E,SUWANEE E,115,785,308,2,1210
Gwinnett LAWRENCEVILLE K,LAWRENCEVILLE K,82,533,345,0,960
Gwinnett HARBINS B,HARBINS B,88,825,315,1,1229
Gwinnett BAYCREEK F,BAYCREEK F,129,1133,592,1,1855
Gwinnett PUCKETTS C,PUCKETTS C,57,453,239,0,749
Gwinnett HOG MOUNTAIN C,HOG MOUNTAIN C,99,631,328,2,1060
Gwinnett ROCKYCREEK B,ROCKYCREEK B,88,768,419,1,1276
Gwinnett DULUTH I,DULUTH I,161,749,361,0,1271
Gwinnett MARTINS K,MARTINS K,115,983,653,4,1755
Gwinnett SUWANEE H,SUWANEE H,97,590,252,1,940
Gwinnett SUGAR HILL G,SUGAR HILL G,71,418,165,0,654
Gwinnett SUWANEE F,SUWANEE F,108,693,341,2,1144
Gwinnett LAWRENCEVILLE L,LAWRENCEVILLE L,126,895,549,1,1571
Gwinnett LAWRENCEVILLE M,LAWRENCEVILLE M,108,1596,693,1,2398
Gwinnett BAYCREEK G,BAYCREEK G,175,1832,848,4,2859
Gwinnett BAYCREEK H,BAYCREEK H,221,1638,735,3,2597
Gwinnett BAYCREEK I,BAYCREEK I,141,1185,524,4,1854
Gwinnett BERKSHIRE Q,BERKSHIRE Q,40,293,169,0,502
Gwinnett GOODWINS I,GOODWINS I,55,454,293,0,802
Gwinnett DULUTH K,DULUTH K,42,406,209,2,659
Gwinnett HARBINS C,HARBINS C,41,573,325,2,941
Gwinnett ROCKYCREEK C,ROCKYCREEK C,78,892,448,1,1419
Gwinnett LAWRENCEVILLE N,LAWRENCEVILLE N,44,374,217,0,635
Gwinnett PUCKETTS D,PUCKETTS D,83,543,227,3,856
Gwinnett SUWANEE G,SUWANEE G,106,700,418,2,1226
Gwinnett BAYCREEK J,BAYCREEK J,112,1084,605,0,1801
Habersham Habersham North,Habersham North,114,759,153,0,1026
Habersham Habersham South,Habersham South,85,409,271,0,765
Habersham Demorest,Demorest,42,259,116,1,418
Habersham Town of Mount Airy,Town of Mount Airy,8,49,28,0,85
Habersham City of Baldwin,City of Baldwin,0,0,0,0,0
Habersham Mud Creek,Mud Creek,52,225,88,0,365
Habersham Amys Creek,Amys Creek,37,140,51,0,228
Hall Wilson,Wilson,243,526,263,0,1032
Hall Chicopee,Chicopee,48,361,277,1,687
Hall Oakwood I,Oakwood I,27,235,215,1,478
Hall Oakwood II,Oakwood II,78,366,197,1,642
Hall Flowery Branch I,Flowery Branch I,72,452,225,1,750
Hall Flowery Branch II,Flowery Branch II,60,361,228,0,649
Hall Roberts,Roberts,95,462,244,0,801
Hall Morgan I,Morgan I,43,270,146,0,459
Hall Morgan II,Morgan II,87,396,269,0,752
Hall Candler,Candler,74,378,273,0,725
Hall Tadmore,Tadmore,82,495,357,0,934
Hall Glade,Glade,55,239,138,0,432
Hall Lula,Lula,31,132,102,0,265
Hall Clermont,Clermont,18,160,65,0,243
Hall Quillians,Quillians,20,134,52,0,206
Hall Bark Camp,Bark Camp,87,404,158,0,649
Hall Chestatee,Chestatee,64,234,149,0,447
Hall Fork,Fork,97,223,151,0,471
Hall Whelchel,Whelchel,55,348,167,0,570
Hall West Whelchel,West Whelchel,137,401,171,0,709
Hall Gainesville I,Gainesville I,80,410,212,3,705
Hall Gainesville II,Gainesville II,184,538,303,0,1025
Hall Gainesville III,Gainesville III,60,334,302,0,696
Hall Gainesville IV,Gainesville IV,71,348,145,0,564
Hall Gainesville V,Gainesville V,30,131,85,0,246
Hall Gillsville,Gillsville,11,34,41,0,86
Hall Big Hickory,Big Hickory,44,234,82,0,360
Hall Friendship I,Friendship I,303,943,328,0,1574
Hall Friendship II,Friendship II,46,383,178,0,607
Hall Friendship III,Friendship III,72,410,177,0,659
Hall Friendship IV,Friendship IV,56,594,123,0,773
Hancock Devereux Fire,Devereux Fire,58,160,108,0,326
Hancock St Mark,St Mark,37,122,82,0,241
Hancock Courthouse,Courthouse,49,193,118,0,360
Hancock Second Beulah,Second Beulah,59,106,72,0,237
Hancock Mayfield Community Center,Mayfield Community Center,34,51,71,0,156
Hancock Power of God,Power of God,55,140,104,0,299
Hancock Warren Chapel,Warren Chapel,20,51,16,0,87
Hancock Youth Center,Youth Center,61,234,145,0,440
Hancock Second Darrien,Second Darrien,32,60,65,1,158
Hancock Sparta 4C,Sparta 4C,15,37,17,0,69
Haralson Bremen,Bremen,73,328,218,0,619
Haralson Buchanan,Buchanan,13,93,46,0,152
Haralson Buncombe,Buncombe,5,23,37,0,65
Haralson Corinth,Corinth,7,45,24,0,76
Haralson Twentieth,Twentieth,1,24,25,0,50
Haralson Felton,Felton,3,2,5,0,10
Haralson Little Creek,Little Creek,0,16,20,0,36
Haralson Mt View,Mt View,0,3,11,0,14
Haralson Seventh,Seventh,11,86,45,0,142
Haralson Berea-Steadman,Berea-Steadman,0,21,12,0,33
Haralson Tallapoosa,Tallapoosa,28,91,123,0,242
Haralson Waco,Waco,0,23,36,0,59
Harris Cataula,Cataula,54,267,162,1,484
Harris Ellerslie,Ellerslie,90,480,264,0,834
Harris Goodman,Goodman,25,189,164,0,378
Harris Hamilton,Hamilton,66,375,141,0,582
Harris Lower 19th,Lower 19th,37,195,133,0,365
Harris Mulberry Grove,Mulberry Grove,51,226,132,0,409
Harris Pine Mountain Valley,Pine Mountain Valley,9,61,42,0,112
Harris Skinner,Skinner,23,51,158,0,232
Harris Upper 19th,Upper 19th,16,78,83,0,177
Harris Valley Plains,Valley Plains,12,37,88,0,137
Harris Waverly Hall,Waverly Hall,72,308,216,0,596
Harris Whitesville,Whitesville,25,116,99,0,240
Hart Hartwell,Hartwell,103,642,275,0,1020
Hart Goldmine,Goldmine,23,78,70,0,171
Hart Cokesbury,Cokesbury,24,120,100,0,244
Hart Reed Creek,Reed Creek,44,206,121,0,371
Hart Bowersville,Bowersville,5,61,73,0,139
Hart Shoal Creek,Shoal Creek,16,80,91,0,187
Hart Bio,Bio,20,95,75,0,190
Heard Centralhatchee,Centralhatchee,25,66,60,1,152
Heard Cooksville-Corinth,Cooksville-Corinth,2,10,23,0,35
Heard Enon Grove,Enon Grove,16,27,24,0,67
Heard Ephesus,Ephesus,9,24,33,0,66
Heard Franklin,Franklin,55,130,84,0,269
Heard Southwest,Southwest,12,32,42,0,86
Henry Locust Grove,Locust Grove,148,2176,576,0,2900
Henry Tussahaw,Tussahaw,23,234,119,0,376
Henry Sandy Ridge,Sandy Ridge,44,524,249,0,817
Henry Westside,Westside,184,1310,570,5,2069
Henry Lowes,Lowes,240,2534,990,1,3765
Henry South Hampton,South Hampton,90,1206,378,1,1675
Henry North Hampton,North Hampton,149,1628,548,1,2326
Henry Mount Carmel,Mount Carmel,178,2027,658,3,2866
Henry Red Oak,Red Oak,131,1897,693,0,2721
Henry Wesley Lakes,Wesley Lakes,127,1801,673,1,2602
Henry McDonough,McDonough,67,857,292,1,1217
Henry McMullen,McMullen,79,488,217,0,784
Henry East Lake,East Lake,54,725,211,0,990
Henry Hickory Flat,Hickory Flat,122,1536,540,0,2198
Henry Stockbridge East-West,Stockbridge East-West,203,1856,632,1,2692
Henry Stagecoach,Stagecoach,71,780,265,0,1116
Henry Cotton Indian,Cotton Indian,81,1202,353,0,1636
Henry Pleasant Grove,Pleasant Grove,87,1061,305,0,1453
Henry Austin Road,Austin Road,64,1114,311,0,1489
Henry Swan Lake,Swan Lake,54,702,220,0,976
Henry Shakerag,Shakerag,102,1663,466,1,2232
Henry Ellenwood,Ellenwood,151,1798,378,0,2327
Henry Unity Grove,Unity Grove,62,755,198,1,1016
Henry Shiloh,Shiloh,126,906,352,2,1386
Henry Pates Creek,Pates Creek,134,1329,439,2,1904
Henry Oakland,Oakland,119,1047,378,0,1544
Henry Lake Dow,Lake Dow,102,992,404,1,1499
Henry Flippen,Flippen,167,1518,418,0,2103
Henry Stockbridge Central,Stockbridge Central,79,996,370,0,1445
Henry Kelleytown,Kelleytown,63,664,299,0,1026
Henry Lighthouse,Lighthouse,81,1047,321,1,1450
Henry Dutchtown,Dutchtown,61,553,231,0,845
Henry Mt Bethel,Mt Bethel,45,398,279,0,722
Henry Grove Park,Grove Park,62,779,312,1,1154
Henry Lake Haven,Lake Haven,86,808,299,0,1193
Henry McDonough Central,McDonough Central,96,1081,331,2,1510
Henry Timberridge,Timberridge,57,459,216,0,732
Houston ANNX,ANNX,135,656,243,1,1035
Houston BMS,BMS,259,1507,583,2,2351
Houston CENT,CENT,146,1234,547,0,1927
Houston CGTC,CGTC,97,811,214,0,1122
Houston FMMS,FMMS,158,1565,720,1,2444
Houston HAFS,HAFS,31,114,96,0,241
Houston HCTC,HCTC,126,874,391,0,1391
Houston HEFS,HEFS,31,123,136,2,292
Houston HHPC,HHPC,192,1542,575,1,2310
Houston MCMS,MCMS,167,1595,494,2,2258
Houston NHSC,NHSC,52,397,110,0,559
Houston ROZR,ROZR,383,1704,742,3,2832
Houston TMS,TMS,128,999,421,0,1548
Houston TWPK,TWPK,104,646,360,0,1110
Houston VHS,VHS,120,1004,377,1,1502
Houston WELL,WELL,276,1667,790,2,2735
Irwin Irwinville,Irwinville,2,45,33,0,80
Irwin Ocilla,Ocilla,50,340,208,4,602
Irwin Holt,Holt,7,36,32,0,75
Jackson Central Jackson,Central Jackson,166,1263,601,1,2031
Jackson North Jackson,North Jackson,141,720,431,0,1292
Jackson West Jackson,West Jackson,201,1248,659,1,2109
Jackson South Jackson,South Jackson,116,631,324,1,1072
Jasper Wyatt,Wyatt,24,88,115,0,227
Jasper Monticello,Monticello,149,569,238,0,956
Jasper Martin & Burney,Martin & Burney,26,128,127,0,281
Jeff Davis Hazlehurst,Hazlehurst,26,177,108,0,311
Jeff Davis Altamaha 1,Altamaha 1,1,19,15,0,35
Jeff Davis Altamaha 2,Altamaha 2,1,11,14,0,26
Jeff Davis Blackburn 1,Blackburn 1,9,37,22,0,68
Jeff Davis Blackburn 2,Blackburn 2,0,10,10,0,20
Jeff Davis Whitehead 1,Whitehead 1,3,52,39,0,94
Jeff Davis Whitehead 2,Whitehead 2,5,10,10,0,25
Jeff Davis Ocmulgee 1,Ocmulgee 1,11,56,39,0,106
Jeff Davis Ocmulgee 2,Ocmulgee 2,2,43,8,0,53
Jefferson Stapleton Crossroads,Stapleton Crossroads,15,42,44,0,101
Jefferson Matthews,Matthews,12,43,53,0,108
Jefferson Wrens,Wrens,90,331,379,0,800
Jefferson Louisville,Louisville,144,724,332,0,1200
Jefferson Wadley,Wadley,101,270,275,0,646
Jefferson Bartow,Bartow,8,73,49,0,130
Jefferson Stapleton,Stapleton,11,46,83,0,140
Jefferson Avera,Avera,3,9,21,0,33
Jenkins Primary School,Primary School,16,182,98,0,296
Jenkins Court House,Court House,17,132,78,0,227
Jenkins Perkins,Perkins,12,91,31,0,134
Jenkins Senior Citizens Center,Senior Citizens Center,5,70,22,0,97
Jenkins Four Points,Four Points,15,80,63,0,158
Johnson Wrightsville,Wrightsville,74,412,169,0,655
Johnson Smith,Smith,0,23,22,0,45
Johnson Bray,Bray,15,64,40,0,119
Johnson Kite,Kite,5,22,23,0,50
Jones Gray,Gray,44,286,106,0,436
Jones Hawkins,Hawkins,154,642,301,0,1097
Jones Ethridge,Ethridge,52,204,114,0,370
Jones Clinton,Clinton,48,242,90,1,381
Jones Roberts,Roberts,37,232,207,0,476
Jones Davidson,Davidson,22,84,45,0,151
Jones Pope,Pope,40,192,130,0,362
Jones Barron,Barron,38,119,60,0,217
Jones Sanders,Sanders,0,8,14,0,22
Jones Finney,Finney,64,227,187,0,478
Lamar Barnesville,Barnesville,111,423,213,0,747
Lamar Chappell Mill V. FD,Chappell Mill V. FD,28,95,68,0,191
Lamar Senior Citzen Bldg,Senior Citzen Bldg,23,158,76,0,257
Lamar Redbone,Redbone,11,32,29,0,72
Lamar L C S C,L C S C,56,228,115,0,399
Lamar Milner,Milner,56,261,156,0,473
Lanier Lakeland,Lakeland,40,430,255,0,725
Laurens FBC-FLC,FBC-FLC,104,518,295,0,917
Laurens Calhoun Park,Calhoun Park,241,903,620,0,1764
Laurens Fire Dept Station 5,Fire Dept Station 5,78,400,186,1,665
Laurens Buckeye,Buckeye,30,123,110,0,263
Laurens Burch,Burch,11,21,26,0,58
Laurens Cadwell,Cadwell,6,23,35,0,64
Laurens Brewton,Brewton,18,80,91,0,189
Laurens Dudley,Dudley,28,109,112,0,249
Laurens Hampton Mill,Hampton Mill,11,45,80,0,136
Laurens Minter,Minter,0,17,28,0,45
Laurens Rural Fire Station 7,Rural Fire Station 7,32,143,125,0,300
Laurens WT Adams Fire Station 18,WT Adams Fire Station 18,68,219,129,0,416
Laurens Reedy Springs,Reedy Springs,11,29,52,0,92
Laurens Smith,Smith,70,326,309,0,705
Laurens LCFS #10,LCFS #10,53,202,166,1,422
Lee Chokee,Chokee,25,55,54,0,134
Lee Redbone,Redbone,34,340,235,1,610
Lee Smithville ,Smithville ,20,81,126,0,227
Lee CJC,CJC,4,37,18,0,59
Lee Leesburg,Leesburg,40,297,181,1,519
Lee Friendship Baptist,Friendship Baptist,7,122,45,0,174
Lee First Baptist,First Baptist,65,472,307,0,844
Lee SDA Church,SDA Church,19,167,117,1,304
Lee Flint Reformed Baptist ,Flint Reformed Baptist ,21,177,154,0,352
Lee Century Fire Station,Century Fire Station,28,291,236,1,556
Liberty Riceboro,Riceboro,66,306,141,1,514
Liberty Lyman Hall,Lyman Hall,120,883,309,0,1312
Liberty Lewis Frasier,Lewis Frasier,60,501,169,0,730
Liberty Memorial Dr,Memorial Dr,66,391,128,0,585
Liberty Performing Arts CTR,Performing Arts CTR,56,413,177,0,646
Liberty Town of Allenhurst,Town of Allenhurst,55,393,146,0,594
Liberty Hinesville,Hinesville,70,559,248,0,877
Liberty Liberty County Complex,Liberty County Complex,166,928,212,1,1307
Liberty Victory Baptist,Victory Baptist,79,841,272,1,1193
Liberty Fleming East,Fleming East,49,255,145,1,450
Liberty Gum Branch,Gum Branch,67,409,158,0,634
Liberty Progressive Church,Progressive Church,76,529,168,0,773
Lincoln Midway,Midway,23,42,40,0,105
Lincoln Lincoln Club House,Lincoln Club House,48,133,103,0,284
Lincoln Lincoln Center,Lincoln Center,38,103,64,0,205
Lincoln Faith Temple of Lincoln,Faith Temple of Lincoln,15,47,36,0,98
Lincoln Tabernacle,Tabernacle,33,97,70,0,200
Lincoln Bethany Church,Bethany Church,5,29,15,0,49
Lincoln Martins Crossroad,Martins Crossroad,16,80,40,0,136
Long Breads Creek,Breads Creek,22,133,107,0,262
Long Rye Patch_Oak Dale,Rye Patch_Oak Dale,21,192,142,0,355
Long South Ludowici,South Ludowici,16,224,107,0,347
Long North Ludowici,North Ludowici,6,257,109,1,373
Long Tibet,Tibet,2,47,27,0,76
Long Alma Flournoy,Alma Flournoy,0,3,1,0,4
Long Faith Baptist Annex,Faith Baptist Annex,4,80,47,0,131
Lowndes Train Depot,Train Depot,26,201,141,0,368
Lowndes Historical Society ,Historical Society ,7,103,57,0,167
Lowndes Hahira Community Center ,Hahira Community Center ,5,73,49,1,128
Lowndes Pine Grove Church,Pine Grove Church,24,231,70,0,325
Lowndes Trinity Church,Trinity Church,57,513,199,2,771
Lowndes Nazarene Church,Nazarene Church,74,784,288,2,1148
Lowndes Mathis Auditorium ,Mathis Auditorium ,187,1484,495,0,2166
Lowndes Jaycee Community Center,Jaycee Community Center,38,436,133,2,609
Lowndes Lowndes Civic,Lowndes Civic,144,1606,523,22,2295
Lowndes Naylor Community Center,Naylor Community Center,13,156,100,0,269
Lowndes Rainwater,Rainwater,236,2082,731,10,3059
Lowndes VSU,VSU,1,17,30,0,48
Lowndes Mt. Calvary Church,Mt. Calvary Church,42,313,129,3,487
Lowndes Mildred Community Center,Mildred Community Center,94,478,275,1,848
Lowndes Paper Mill Union,Paper Mill Union,38,184,132,2,356
Lowndes Dasher City Hall,Dasher City Hall,20,124,75,0,219
Lowndes Lake Park,Lake Park,46,205,143,2,396
Lowndes South Lowndes Recreation Center,South Lowndes Recreation Center,26,104,60,0,190
Lumpkin Dahlonega,Dahlonega,264,1720,555,0,2539
Macon Ideal,Ideal,27,217,92,0,336
Macon Oglethorpe,Oglethorpe,34,287,87,0,408
Macon Marshallville,Marshallville,35,158,258,0,451
Macon Montezuma #4,Montezuma #4,47,322,180,0,549
Macon Montezuma #5,Montezuma #5,54,289,182,0,525
Madison Colbert,Colbert,50,293,221,0,564
Madison Collins,Collins,1,22,26,0,49
Madison Comer,Comer,66,122,138,0,326
Madison Danielsville,Danielsville,26,216,65,0,307
Madison Fork,Fork,18,40,57,0,115
Madison Harrison,Harrison,2,6,19,0,27
Madison Hull,Hull,53,433,375,1,862
Madison Ila,Ila,20,76,46,0,142
Madison Mill,Mill,23,64,46,0,133
Madison Paoli,Paoli,3,8,10,0,21
Madison Pittman,Pittman,29,110,90,0,229
Madison Poca,Poca,10,39,40,0,89
Marion Pineknot,Pineknot,6,21,18,0,45
Marion Buena Vista,Buena Vista,137,481,203,0,821
Marion Tazewell,Tazewell,6,16,21,0,43
Marion Brantley,Brantley,7,13,10,0,30
Marion Fort Perry,Fort Perry,3,41,35,0,79
McDuffie NMcDuffie,NMcDuffie,4,58,19,0,81
McDuffie Cedar Rock,Cedar Rock,237,869,362,0,1468
McDuffie Depot,Depot,108,291,181,0,580
McDuffie Sweetwater,Sweetwater,15,103,45,0,163
McDuffie White Oak,White Oak,44,233,78,0,355
McDuffie Dearing,Dearing,40,153,63,0,256
McDuffie Fort Creek,Fort Creek,31,130,39,0,200
McIntosh Sapelo Island,Sapelo Island,3,4,19,0,26
McIntosh Crescent,Crescent,75,412,241,1,729
McIntosh Darien,Darien,58,311,98,0,467
McIntosh South Newport,South Newport,61,252,95,0,408
McIntosh North Darien,North Darien,34,263,121,0,418
Meriwether Chalybeate,Chalybeate,12,16,20,0,48
Meriwether Gill I,Gill I,36,112,172,0,320
Meriwether Gill II,Gill II,58,144,197,0,399
Meriwether 7th-Odessadale,7th-Odessadale,18,27,42,0,87
Meriwether 8th-Greenville,8th-Greenville,64,311,130,0,505
Meriwether Lone Oak,Lone Oak,47,159,128,0,334
Meriwether Luthersville,Luthersville,58,250,222,0,530
Meriwether Upper 9th-Alvaton,Upper 9th-Alvaton,29,98,162,0,289
Meriwether Middle 9th-Gay,Middle 9th-Gay,9,20,30,0,59
Meriwether Lower 9th-Woodbury,Lower 9th-Woodbury,23,123,224,0,370
Meriwether 2nd-Warm Springs,2nd-Warm Springs,13,79,129,0,221
Meriwether Third-Durand,Third-Durand,16,60,59,1,136
Meriwether Raleigh,Raleigh,8,28,16,0,52
Meriwether Cove,Cove,0,2,11,0,13
Miller Colquitt-Miller,Colquitt-Miller,54,244,211,0,509
Mitchell Baconton,Baconton,23,118,116,0,257
Mitchell Branchville,Branchville,7,28,18,0,53
Mitchell Camilla North,Camilla North,124,360,269,0,753
Mitchell Camilla South,Camilla South,132,545,252,0,929
Mitchell Cotton,Cotton,0,5,13,0,18
Mitchell Hopeful,Hopeful,5,14,12,0,31
Mitchell Hinsonton,Hinsonton,2,4,5,0,11
Mitchell Lester,Lester,16,67,38,0,121
Mitchell Pebble City,Pebble City,1,6,8,0,15
Mitchell Pelham,Pelham,81,363,277,0,721
Mitchell Sale City,Sale City,5,7,32,0,44
Monroe Bentons,Bentons,38,235,103,0,376
Monroe Brantleys,Brantleys,7,62,52,0,121
Monroe Burgays,Burgays,26,184,106,0,316
Monroe Cabaniss,Cabaniss,11,68,52,1,132
Monroe Cox,Cox,17,54,33,0,104
Monroe Culloden,Culloden,9,21,62,1,93
Monroe Dillards,Dillards,6,65,39,0,110
Monroe Evers,Evers,26,185,101,0,312
Monroe Forsyth,Forsyth,191,851,345,0,1387
Monroe High Falls,High Falls,15,121,61,0,197
Monroe Kelseys,Kelseys,23,117,77,0,217
Monroe Middlebrooks,Middlebrooks,3,88,43,0,134
Monroe Proctors,Proctors,13,82,93,0,188
Monroe Russellville,Russellville,2,21,27,0,50
Montgomery Ailey,Ailey,7,41,36,0,84
Montgomery Alston,Alston,7,12,17,0,36
Montgomery Higgston,Higgston,13,84,66,0,163
Montgomery Kibbee,Kibbee,0,12,18,0,30
Montgomery Mount Vernon,Mount Vernon,18,148,116,0,282
Montgomery Tarrytown,Tarrytown,1,3,8,0,12
Montgomery Uvalda,Uvalda,10,78,47,0,135
Morgan Rec Dept,Rec Dept,96,643,256,1,996
Morgan Centennial,Centennial,25,215,133,0,373
Morgan Gibbs,Gibbs,31,276,137,0,444
Morgan DFACS,DFACS,59,314,108,0,481
Morgan Buckhead,Buckhead,57,266,145,0,468
Murray McDonald,McDonald,14,85,62,0,161
Murray Shuck Pen,Shuck Pen,10,58,117,0,185
Murray Southwest,Southwest,9,68,97,0,174
Murray Spring Place,Spring Place,20,127,139,0,286
Murray Town,Town,35,269,182,0,486
Murray Carters-Doolittle,Carters-Doolittle,9,51,53,0,113
Murray North,North,9,46,73,0,128
Muscogee Wynnton,Wynnton,213,996,542,0,1751
Muscogee Carver/Library,Carver/Library,240,985,288,0,1513
Muscogee Shirley Winston,Shirley Winston,303,1695,401,0,2399
Muscogee Britt David,Britt David,55,250,203,0,508
Muscogee St Peter,St Peter,63,365,296,0,724
Muscogee Chattahoochee,Chattahoochee,125,859,465,2,1451
Muscogee Columbus Tech,Columbus Tech,81,390,214,1,686
Muscogee Central,Central,160,819,365,1,1345
Muscogee Wynnbrook,Wynnbrook,99,344,131,1,575
Muscogee Cusseta Rd,Cusseta Rd,224,941,547,0,1712
Muscogee OLOLC,OLOLC,343,1208,745,1,2297
Muscogee Mt Pilgrim,Mt Pilgrim,301,1751,605,4,2661
Muscogee Faith Tabernacle,Faith Tabernacle,225,1236,437,1,1899
Muscogee Canaan,Canaan,298,1513,524,0,2335
Muscogee Holsey,Holsey,268,1967,586,1,2822
Muscogee Gentian,Gentian,124,929,325,0,1378
Muscogee St Paul,St Paul,128,825,402,0,1355
Muscogee Moon,Moon,119,597,383,0,1099
Muscogee St Andrews,St Andrews,214,1207,604,1,2026
Muscogee Salvation Army,Salvation Army,60,516,304,2,882
Muscogee First African,First African,52,231,172,0,455
Muscogee Epworth,Epworth,70,441,316,0,827
Muscogee Gallops,Gallops,73,400,248,1,722
Muscogee Edgewood,Edgewood,113,705,247,1,1066
Muscogee Psalmond,Psalmond,212,1576,585,0,2373
Newton 01-City Pond,01-City Pond,89,207,181,0,477
Newton 02-Town,02-Town,256,773,390,0,1419
Newton 03-Almon,03-Almon,186,1310,627,0,2123
Newton 04-Alcovy,04-Alcovy,109,829,428,0,1366
Newton 05-Covington Mills,05-Covington Mills,100,492,340,0,932
Newton 06-Brewers,06-Brewers,98,295,265,0,658
Newton 07-Brick Store,07-Brick Store,52,276,207,0,535
Newton 08-Cedar Shoals,08-Cedar Shoals,91,513,290,0,894
Newton 09-Livingston,09-Livingston,167,1116,510,0,1793
Newton 10-Downs,10-Downs,157,1395,517,0,2069
Newton 12-Gum Creek,12-Gum Creek,95,579,222,0,896
Newton 13-Beaverdam,13-Beaverdam,175,1339,722,1,2237
Newton 14-Leguinn,14-Leguinn,49,188,151,0,388
Newton 15-Mansfield,15-Mansfield,23,58,62,0,143
Newton 16-Newborn,16-Newborn,8,26,79,0,113
Newton 17-Oxford,17-Oxford,51,196,212,0,459
Newton 18-Rocky Plains,18-Rocky Plains,78,483,330,1,892
Newton 19-Buck Creek,19-Buck Creek,132,960,372,0,1464
Newton 20-Stansells,20-Stansells,170,1234,626,3,2033
Newton 23-Fairview,23-Fairview,91,647,392,0,1130
Newton 24-Crowell,24-Crowell,174,1226,591,0,1991
Newton 25-Hub,25-Hub,28,155,153,0,336
Oconee City Hall,City Hall,103,779,246,0,1128
Oconee Colham Ferry,Colham Ferry,62,495,144,0,701
Oconee Bishop,Bishop,52,403,147,0,602
Oconee North Oconee,North Oconee,32,363,158,0,553
Oconee Dark Corner,Dark Corner,51,376,178,0,605
Oconee Bogart,Bogart,31,249,201,0,481
Oconee Marswood Hall,Marswood Hall,116,655,230,1,1002
Oconee Civic Center,Civic Center,245,1288,382,0,1915
Oglethorpe Beaverdam,Beaverdam,53,349,260,0,662
Oglethorpe Crawford,Crawford,76,320,169,0,565
Oglethorpe Lexington,Lexington,94,484,190,1,769
Paulding Burnt Hickory Park,Burnt Hickory Park,63,483,272,0,818
Paulding Crossroads Library,Crossroads Library,74,414,250,0,738
Paulding Shelton Elementary,Shelton Elementary,121,812,444,4,1381
Paulding Russom Elementary,Russom Elementary,295,1380,756,0,2431
Paulding Paulding Sr Center,Paulding Sr Center,125,878,440,0,1443
Paulding Legacy Bapt Church,Legacy Bapt Church,100,616,299,0,1015
Paulding Watson Govt Cmplx,Watson Govt Cmplx,203,1320,624,2,2149
Paulding East Paulding Middle Sch,East Paulding Middle Sch,242,1538,675,4,2459
Paulding Events Place,Events Place,164,1135,487,6,1792
Paulding Poplar Sprgs Bapt Church,Poplar Sprgs Bapt Church,110,879,412,3,1404
Paulding D Wright Innovation Ctr,D Wright Innovation Ctr,112,1037,383,3,1535
Paulding Taylor Farm Park,Taylor Farm Park,39,330,196,1,566
Paulding Nebo Elem School,Nebo Elem School,144,913,473,1,1531
Paulding White Oak Park,White Oak Park,105,660,380,0,1145
Paulding Mulberry Rock Park,Mulberry Rock Park,63,464,262,0,789
Paulding Beulahland Baptist Church,Beulahland Baptist Church,25,160,88,0,273
Paulding Paulding County Airport,Paulding County Airport,60,289,180,0,529
Paulding Dobbins Middle School,Dobbins Middle School,198,1577,616,0,2391
Peach Byron #1,Byron #1,20,343,125,3,491
Peach Byron #2,Byron #2,102,823,272,1,1198
Peach Claude,Claude,9,58,32,0,99
Peach Fort Valley #1,Fort Valley #1,72,505,249,0,826
Peach Fort Valley #2,Fort Valley #2,58,495,231,0,784
Peach Fort Valley #3,Fort Valley #3,119,696,224,2,1041
Peach Powersville,Powersville,23,171,68,0,262
Pickens Yellow Creek,Yellow Creek,67,343,140,0,550
Pickens Sharptop,Sharptop,73,267,110,0,450
Pickens Appalachian,Appalachian,25,130,56,0,211
Pickens Refuge,Refuge,25,127,60,0,212
Pickens Hill City,Hill City,16,132,69,0,217
Pickens Hinton,Hinton,9,16,31,0,56
Pickens Jerusalem,Jerusalem,9,28,47,0,84
Pickens Ludville,Ludville,3,13,22,0,38
Pickens Nelson,Nelson,7,61,65,0,133
Pickens Talking Rock,Talking Rock,18,67,35,0,120
Pickens Jasper,Jasper,29,203,92,0,324
Pickens Tate,Tate,22,111,61,0,194
Pierce Hacklebarney/Cason ,Hacklebarney/Cason ,39,226,69,0,334
Pierce Blackshear,Blackshear,9,112,38,0,159
Pierce St. Johns/Blackshear,St. Johns/Blackshear,2,43,20,0,65
Pierce Otter Creek,Otter Creek,6,49,16,0,71
Pierce Patterson,Patterson,11,42,27,0,80
Pierce Mershon,Mershon,1,10,2,0,13
Pierce Alabaha,Alabaha,5,33,12,0,50
Pierce Sunset/Sweat,Sunset/Sweat,0,5,2,0,7
Pike Concord,Concord,27,81,72,0,180
Pike Hollonville,Hollonville,19,67,33,0,119
Pike Meansville,Meansville,15,46,41,0,102
Pike Molena,Molena,10,71,71,0,152
Pike Second District,Second District,25,123,47,0,195
Pike Lifsey Springs,Lifsey Springs,15,43,32,0,90
Pike Williamson,Williamson,5,85,52,0,142
Pike Zebulon,Zebulon,50,172,55,0,277
Polk Aragon,Aragon,19,172,104,0,295
Polk Blooming Grove,Blooming Grove,11,85,37,0,133
Polk Cedartown,Cedartown,103,621,237,1,962
Polk Fish Creek,Fish Creek,24,152,63,0,239
Polk Lake Creek,Lake Creek,12,159,88,0,259
Polk Rockmart,Rockmart,60,501,206,0,767
Polk Youngs Grove,Youngs Grove,17,73,47,2,139
Pulaski Annex,Annex,118,618,265,1,1002
Putnam 101,101,96,478,225,0,799
Putnam 104,104,110,559,230,0,899
Putnam 105,105,83,278,127,0,488
Putnam 106,106,17,69,49,0,135
Putnam 107,107,69,317,140,0,526
Quitman Georgetown,Georgetown,35,191,124,0,350
Quitman Morris,Morris,1,5,22,0,28
Rabun Rabun County,Rabun County,254,1229,321,0,1804
Randolph Coleman,Coleman,3,20,36,0,59
Randolph Shellman,Shellman,60,66,148,0,274
Randolph Benevolence,Benevolence,3,18,36,0,57
Randolph Cuthbert-Courthouse,Cuthbert-Courthouse,106,417,172,0,695
Randolph Cuthbert,Cuthbert,16,98,56,0,170
Randolph Springvale,Springvale,6,69,36,0,111
Richmond 101,101,36,153,197,0,386
Richmond 102,102,49,117,118,0,284
Richmond 103,103,66,227,205,0,498
Richmond 104,104,128,464,462,0,1054
Richmond 105,105,41,175,154,0,370
Richmond 106,106,28,79,126,1,234
Richmond 107,107,67,240,237,0,544
Richmond 108,108,26,122,75,0,223
Richmond 109,109,12,77,68,0,157
Richmond 110,110,45,190,265,0,500
Richmond 111,111,42,218,209,0,469
Richmond 112,112,58,243,151,0,452
Richmond 115,115,15,34,53,0,102
Richmond 201,201,48,325,277,1,651
Richmond 202,202,86,628,510,4,1228
Richmond 203,203,28,136,187,2,353
Richmond 204,204,43,190,223,0,456
Richmond 207,207,88,380,321,1,790
Richmond 208,208,66,391,340,2,799
Richmond 210,210,74,353,181,0,608
Richmond 301,301,42,220,197,0,459
Richmond 302,302,12,107,130,0,249
Richmond 303,303,19,166,107,0,292
Richmond 304,304,15,88,71,0,174
Richmond 306,306,102,663,437,3,1205
Richmond 307,307,49,188,156,0,393
Richmond 308,308,5,72,59,0,136
Richmond 310,310,186,1363,811,1,2361
Richmond 401,401,75,355,213,0,643
Richmond 402,402,111,415,444,1,971
Richmond 403,403,93,558,253,0,904
Richmond 405,405,231,1902,700,2,2835
Richmond 406,406,163,1093,424,1,1681
Richmond 501,501,136,792,418,0,1346
Richmond 502,502,96,528,396,0,1020
Richmond 503,503,71,477,212,0,760
Richmond 504,504,90,427,307,1,825
Richmond 505,505,73,431,153,0,657
Richmond 506,506,118,1024,541,0,1683
Richmond 507,507,25,154,154,0,333
Richmond 601,601,97,689,377,2,1165
Richmond 602,602,17,135,98,0,250
Richmond 604,604,34,228,223,2,487
Richmond 605,605,122,597,465,1,1185
Richmond 606,606,65,409,252,1,727
Richmond 607,607,165,1215,620,4,2004
Richmond 608,608,2,5,17,0,24
Richmond 701,701,62,288,220,0,570
Richmond 702,702,23,128,186,0,337
Richmond 703,703,66,450,419,1,936
Richmond 704,704,2,54,31,0,87
Richmond 705,705,48,335,198,0,581
Richmond 706,706,56,528,221,0,805
Richmond 707,707,52,385,296,0,733
Richmond 708,708,3,34,50,0,87
Richmond 709,709,14,99,74,1,188
Richmond 801,801,3,4,11,0,18
Richmond 801B,801B,3,23,53,0,79
Richmond 802,802,55,236,284,0,575
Richmond 803,803,2,11,8,0,21
Richmond 804,804,42,361,164,1,568
Richmond 804H,804H,72,425,281,0,778
Richmond 805,805,7,150,142,0,299
Richmond 806,806,24,286,269,1,580
Richmond 807,807,37,282,192,0,511
Richmond 808,808,50,372,261,0,683
Richmond 810,810,9,88,38,0,135
Richmond 811,811,7,32,30,0,69
Rockdale BA,BA,115,1291,486,3,1895
Rockdale BT,BT,72,554,254,0,880
Rockdale CO,CO,89,860,349,1,1299
Rockdale FI,FI,196,2027,611,3,2837
Rockdale FS,FS,153,1259,364,4,1780
Rockdale HC,HC,51,514,251,0,816
Rockdale HI,HI,99,937,328,1,1365
Rockdale LA,LA,61,423,192,1,677
Rockdale LO,LO,97,1087,379,2,1565
Rockdale MA,MA,86,660,292,1,1039
Rockdale MI,MI,107,1123,402,1,1633
Rockdale OT,OT,189,1599,625,4,2417
Rockdale RO,RO,142,1514,407,0,2063
Rockdale SM,SM,108,1366,391,2,1867
Rockdale SP,SP,144,1521,468,1,2134
Rockdale ST,ST,76,912,222,1,1211
Schley Precinct One,Precinct One,54,236,94,0,384
Screven Sylvania,Sylvania,37,191,72,0,300
Screven Hunters,Hunters,8,47,31,0,86
Screven Newington,Newington,12,94,91,0,197
Screven Jenk Hill Fire Sta,Jenk Hill Fire Sta,27,190,93,0,310
Screven Rocky Ford,Rocky Ford,6,50,30,0,86
Screven Bay Branch,Bay Branch,1,55,26,0,82
Screven Hiltonia,Hiltonia,14,112,80,0,206
Screven Screven Rec Dept,Screven Rec Dept,5,67,39,0,111
Screven Greenhill Church,Greenhill Church,7,55,33,0,95
Screven Sr Citizens Center,Sr Citizens Center,28,210,147,0,385
Screven Jackson Fire Station,Jackson Fire Station,7,35,15,0,57
Screven Cooperville Fire Station,Cooperville Fire Station,7,50,37,0,94
Seminole Precinct 1,Precinct 1,6,67,67,0,140
Seminole Precinct 2,Precinct 2,12,107,69,0,188
Seminole Precinct 3,Precinct 3,22,157,142,0,321
Seminole Precinct 4,Precinct 4,7,46,51,0,104
Seminole Precinct 5,Precinct 5,7,34,33,0,74
Spalding 01,01,65,235,250,1,551
Spalding 02,02,76,305,233,0,614
Spalding 03,03,59,305,138,0,502
Spalding 05,05,76,552,340,1,969
Spalding 06,06,83,362,218,1,664
Spalding 07,07,30,163,113,0,306
Spalding 08,08,28,159,130,1,318
Spalding 09,09,10,86,60,0,156
Spalding 10,10,19,269,152,1,441
Spalding 11,11,33,344,158,1,536
Spalding 12,12,30,130,68,0,228
Spalding 13,13,25,115,85,0,225
Spalding 14,14,22,119,139,0,280
Spalding 16,16,141,820,436,0,1397
Spalding 17,17,22,176,129,0,327
Spalding 19,19,36,254,189,1,480
Spalding 20,20,18,119,71,1,209
Spalding 21,21,238,1099,220,1,1558
Stephens Senior Center,Senior Center,191,1161,409,1,1762
Stewart Richland,Richland,80,138,173,1,392
Stewart Louvale,Louvale,13,27,63,0,103
Stewart Lumpkin,Lumpkin,41,244,82,0,367
Stewart Omaha,Omaha,7,7,40,0,54
Sumter Agri-Center,Agri-Center,81,306,82,1,470
Sumter Airport,Airport,46,317,130,1,494
Sumter Andersonville,Andersonville,10,28,23,0,61
Sumter Browns Mill,Browns Mill,22,125,58,0,205
Sumter Concord,Concord,3,21,7,0,31
Sumter JROTC,JROTC,69,461,210,0,740
Sumter Leslie,Leslie,66,183,122,0,371
Sumter Plains,Plains,30,122,143,0,295
Sumter Rec Dept,Rec Dept,159,687,245,1,1092
Sumter Rees Park,Rees Park,143,578,258,0,979
Sumter Thompson,Thompson,18,80,58,0,156
Talbot ONeal,ONeal,17,79,63,0,159
Talbot Valley,Valley,20,102,113,0,235
Talbot Junction City,Junction City,29,44,77,0,150
Talbot Geneva,Geneva,24,61,83,0,168
Talbot Talbotton,Talbotton,59,209,193,0,461
Talbot Box Springs,Box Springs,16,30,58,0,104
Talbot Flint Hill,Flint Hill,64,165,182,0,411
Taliaferro Sharon,Sharon,16,22,51,0,89
Taliaferro Crawfordville,Crawfordville,78,213,102,1,394
Tattnall Cobbtown,Cobbtown,9,35,31,0,75
Tattnall Collins,Collins,14,114,58,0,186
Tattnall District II,District II,23,273,96,0,392
Tattnall District IV,District IV,41,205,144,0,390
Tattnall District V,District V,3,41,20,0,64
Tattnall East Glennville,East Glennville,35,127,87,0,249
Tattnall Manassas,Manassas,3,30,28,0,61
Tattnall Shiloh,Shiloh,6,71,31,0,108
Taylor Precinct 1,Precinct 1,48,243,161,7,459
Taylor Precinct 5,Precinct 5,23,142,49,0,214
Taylor Precinct 6,Precinct 6,94,203,174,1,472
Telfair Helena,Helena,7,80,74,0,161
Telfair Jacksonville,Jacksonville,10,23,48,0,81
Telfair Lumber-City,Lumber-City,16,47,110,0,173
Telfair McRae,McRae,89,281,150,0,520
Telfair Milan,Milan,7,25,24,0,56
Telfair Scotland,Scotland,4,14,23,0,41
Terrell Dawson ,Dawson ,158,608,352,0,1118
Terrell Sasser,Sasser,19,139,100,0,258
Terrell Bronwood,Bronwood,25,116,92,0,233
Terrell Parrott,Parrott,18,29,60,0,107
Terrell Graves,Graves,23,53,40,0,116
Terrell Herod-Dover,Herod-Dover,11,29,32,0,72
Thomas Barwick,Barwick,5,29,43,0,77
Thomas Boston,Boston,36,209,133,1,379
Thomas Central,Central,56,442,148,0,646
Thomas Coolidge,Coolidge,13,45,52,0,110
Thomas Douglass,Douglass,48,517,289,0,854
Thomas Little Ochlocknee Baptist,Little Ochlocknee Baptist,6,88,37,0,131
Thomas Fire Station #2,Fire Station #2,30,160,52,0,242
Thomas Gatlin Creek,Gatlin Creek,31,189,82,1,303
Thomas Harper,Harper,65,465,216,0,746
Thomas Jerger,Jerger,43,289,94,0,426
Thomas Meigs,Meigs,7,46,113,0,166
Thomas Merrillville,Merrillville,9,81,25,0,115
Thomas Metcalfe,Metcalfe,6,20,24,0,50
Thomas New Covenant,New Covenant,18,204,67,0,289
Thomas Ochlocknee,Ochlocknee,3,53,46,0,102
Thomas Pavo,Pavo,1,22,15,1,39
Thomas Patten,Patten,10,30,25,0,65
Thomas Remington Esc,Remington Esc,28,323,129,1,481
Thomas Resource Center,Resource Center,67,397,163,1,628
Thomas Scott,Scott,42,409,136,0,587
Tift Tifton NE,Tifton NE,48,298,155,0,501
Tift Brighton,Brighton,27,157,62,0,246
Tift Brookfield ,Brookfield ,5,59,43,0,107
Tift Chula,Chula,7,69,40,0,116
Tift Docia,Docia,2,47,26,0,75
Tift Eldorado,Eldorado,4,32,36,0,72
Tift Omega,Omega,2,26,54,0,82
Tift TY TY,TY TY,4,71,78,0,153
Tift Tifton NW,Tifton NW,39,340,160,1,540
Tift Tifton South,Tifton South,66,331,189,1,587
Tift Mott-Litman Gym,Mott-Litman Gym,72,515,277,0,864
Tift Tifton Lodge ,Tifton Lodge ,54,329,152,0,535
Toombs 15361 Lyons,15361 Lyons,57,230,121,0,408
Toombs 39 Newbranch,39 Newbranch,25,40,20,0,85
Toombs 43 Cedar Crossing,43 Cedar Crossing,4,18,13,0,35
Toombs 513 VPD,513 VPD,107,520,266,1,894
Toombs 514 STIALC,514 STIALC,91,352,197,0,640
Towns Young Harris,Young Harris,62,333,77,2,474
Towns Hiawassee,Hiawassee,150,629,109,0,888
Treutlen Annex,Annex,9,79,25,0,113
Treutlen Soperton,Soperton,73,361,162,2,598
Troup Hollis Hand,Hollis Hand,63,315,175,0,553
Troup Administration Bldg,Administration Bldg,125,473,357,0,955
Troup Hammett Rd,Hammett Rd,90,638,520,2,1250
Troup Griggs Center,Griggs Center,106,385,330,3,824
Troup West Point,West Point,70,123,364,2,559
Troup Hogansville,Hogansville,67,255,380,0,702
Troup East Vernon,East Vernon,26,204,156,0,386
Troup Rosemont,Rosemont,43,292,153,0,488
Troup McClendon,McClendon,46,311,180,0,537
Troup Long Cane,Long Cane,46,258,194,0,498
Troup Gardner Newman,Gardner Newman,55,386,238,1,680
Troup Gray Hill,Gray Hill,16,120,139,0,275
Troup Highland,Highland,40,296,148,1,485
Troup Northside,Northside,47,343,224,0,614
Turner Ashburn,Ashburn,52,564,276,1,893
Turner Sycamore,Sycamore,4,125,63,0,192
Turner Rebecca,Rebecca,4,38,25,0,67
Twiggs Dry Branch,Dry Branch,13,62,65,0,140
Twiggs Golden Isles,Golden Isles,106,209,254,5,574
Twiggs Higgsville,Higgsville,6,59,54,0,119
Twiggs Jeffersonville-Ware,Jeffersonville-Ware,99,263,172,0,534
Twiggs Shady Grove-Tarvers,Shady Grove-Tarvers,53,101,80,0,234
Union Blairsville,Blairsville,56,230,63,0,349
Union Coosa,Coosa,33,149,51,0,233
Union Choestoe,Choestoe,26,118,43,0,187
Union Jones Creek,Jones Creek,36,161,70,0,267
Union Owltown,Owltown,24,163,53,0,240
Union Ivy Log,Ivy Log,31,170,58,0,259
Union Suches,Suches,12,32,32,0,76
Union Trackrock,Trackrock,32,96,41,0,169
Union Dooley,Dooley,21,144,72,0,237
Union Gumlog,Gumlog,33,177,48,0,258
Union Pat Colwell,Pat Colwell,30,256,60,0,346
Upson Yatesville,Yatesville,21,97,90,0,208
Upson Salem,Salem,20,100,105,0,225
Upson Redbone,Redbone,126,659,232,0,1017
Upson Town,Town,217,1063,442,1,1723
Walker La Fayette,La Fayette,70,313,236,0,619
Walker Walnut Grove,Walnut Grove,10,71,56,0,137
Walker Rock Spring,Rock Spring,66,308,176,0,550
Walker Armuchee Valley,Armuchee Valley,10,36,79,0,125
Walker Mountain,Mountain,15,64,75,0,154
Walker Chattanooga Valley,Chattanooga Valley,111,346,304,0,761
Walker Kensington,Kensington,15,70,68,0,153
Walker Rossville,Rossville,80,348,272,0,700
Walker Chickamauga,Chickamauga,69,340,215,0,624
Walker Fairyland,Fairyland,14,134,129,0,277
Walker Fairview,Fairview,28,134,115,0,277
Walton Bold Springs,Bold Springs,48,383,201,0,632
Walton Whatley,Whatley,20,67,59,0,146
Walton Walker Park,Walker Park,47,219,138,0,404
Walton Gratis,Gratis,20,51,50,0,121
Walton Between,Between,54,414,204,2,674
Walton Walnut Grove,Walnut Grove,42,171,98,0,311
Walton Loganvile North,Loganvile North,49,538,269,0,856
Walton Social Circle,Social Circle,72,481,217,0,770
Walton South Monroe,South Monroe,60,363,182,1,606
Walton North Monroe,North Monroe,107,645,391,1,1144
Walton Loganville South,Loganville South,60,372,211,0,643
Walton West Walton,West Walton,46,337,234,0,617
Walton Broken Arrow,Broken Arrow,46,287,150,0,483
Walton Bay Creek,Bay Creek,36,280,119,0,435
Walton E Monroe,E Monroe,40,392,279,2,713
Walton W Monroe,W Monroe,18,169,88,0,275
Walton Tara,Tara,58,824,308,0,1190
Walton Mountain,Mountain,18,87,77,0,182
Walton Jersey,Jersey,11,66,69,0,146
Walton Blasingame,Blasingame,20,42,30,0,92
Walton Good Hope,Good Hope,28,140,94,0,262
Ware 100 - City Auditorium,100 - City Auditorium,197,995,272,0,1464
Ware 200A - Memorial Stadium,200A - Memorial Stadium,64,409,131,0,604
Ware 200B - City Auditorium,200B - City Auditorium,17,96,39,0,152
Ware 300 - Ware BoE Transportation,300 - Ware BoE Transportation,51,256,112,0,419
Ware 304 - Ware BoE Learning Center,304 - Ware BoE Learning Center,3,23,20,0,46
Ware 400 - Second Baptist Church,400 - Second Baptist Church,8,20,59,0,87
Ware 404 - Bickley UM Church,404 - Bickley UM Church,8,8,12,0,28
Ware 405 - Haywood Baptist Church,405 - Haywood Baptist Church,2,8,6,0,16
Ware 406 - Jamestown Baptist Church,406 - Jamestown Baptist Church,6,44,26,0,76
Ware 407 - Manor Commmunity Center,407 - Manor Commmunity Center,2,5,11,0,18
Ware 408 - Millwood Baptist Church,408 - Millwood Baptist Church,1,5,11,0,17
Ware 409 - Waresboro Church of God,409 - Waresboro Church of God,2,30,17,0,49
Warren Warrenton,Warrenton,141,583,392,1,1117
Washington Riddleville,Riddleville,16,51,57,0,124
Washington Warthen,Warthen,18,55,104,0,177
Washington Tennille,Tennille,79,398,317,0,794
Washington Oconee,Oconee,24,64,68,0,156
Washington Harrison,Harrison,25,88,92,0,205
Washington Davisboro,Davisboro,22,66,112,0,200
Washington Sandersville,Sandersville,333,1151,557,1,2042
Washington Deepstep,Deepstep,18,33,44,0,95
Wayne Odum,Odum,11,26,41,0,78
Wayne Madray Springs,Madray Springs,5,35,9,0,49
Wayne Oglethorpe,Oglethorpe,4,84,29,0,117
Wayne Screven,Screven,10,63,61,0,134
Wayne Empire,Empire,8,31,18,0,57
Wayne Red Hill,Red Hill,4,67,25,0,96
Wayne Altamaha,Altamaha,21,181,69,0,271
Wayne Gardi,Gardi,9,29,30,0,68
Wayne VFW,VFW,30,263,81,1,375
Wayne Pine Street,Pine Street,12,138,71,0,221
Wayne Unity,Unity,15,194,85,0,294
Wayne Rec Center,Rec Center,13,142,99,0,254
Webster Preston 1,Preston 1,73,202,166,1,442
Wheeler Alamo,Alamo,30,187,127,1,345
Wheeler Glenwood,Glenwood,12,90,87,0,189
White Blue Creek,Blue Creek,36,200,86,0,322
White Blue Ridge,Blue Ridge,6,56,35,0,97
White Robertstown-Helen,Robertstown-Helen,8,86,46,0,140
White Mossy Creek,Mossy Creek,13,117,83,0,213
White Mt Yonah,Mt Yonah,37,296,105,0,438
White Nacoochee,Nacoochee,48,162,89,0,299
White Shoal Creek,Shoal Creek,26,96,46,0,168
White Tesnatee,Tesnatee,13,79,32,0,124
White Town Creek,Town Creek,27,101,45,0,173
White White Creek,White Creek,11,55,23,0,89
Whitefield 1A,1A,40,189,197,0,426
Whitefield 2A,2A,29,249,205,0,483
Whitefield 3A,3A,29,213,175,0,417
Whitefield 4A,4A,26,264,182,1,473
Whitefield 5A,5A,23,159,218,0,400
Whitefield 6A,6A,17,98,191,0,306
Whitefield AN,AN,9,155,159,0,323
Whitefield CA,CA,8,49,88,0,145
Whitefield CO,CO,14,40,80,1,135
Whitefield DG,DG,32,182,263,0,477
Whitefield ES,ES,17,80,103,0,200
Whitefield FI,FI,11,107,127,1,246
Whitefield GL,GL,24,131,178,1,334
Whitefield LT,LT,7,30,38,0,75
Whitefield MC,MC,4,66,66,0,136
Whitefield NI,NI,22,69,100,0,191
Whitefield PG,PG,38,291,245,1,575
Whitefield TH,TH,46,155,175,1,377
Whitefield TI,TI,3,14,29,0,46
Whitefield TR,TR,9,35,66,0,110
Whitefield UT,UT,4,24,57,0,85
Whitefield VA,VA,49,270,299,3,621
Whitefield WS,WS,21,180,122,0,323
Wilcox Rochelle North #1,Rochelle North #1,11,65,75,0,151
Wilcox Abbeville North #2,Abbeville North #2,9,50,23,0,82
Wilcox Pineview #2,Pineview #2,10,47,89,0,146
Wilcox Pitts #3,Pitts #3,3,18,32,0,53
Wilcox Rochelle South #4,Rochelle South #4,6,39,30,0,75
Wilcox Abbeville South #5,Abbeville South #5,5,80,52,0,137
Wilkes Senior Citizen Center,Senior Citizen Center,66,283,166,0,515
Wilkes Young Famer's Bldg,Young Famer's Bldg,14,111,62,0,187
Wilkes Metasville Fire Sta,Metasville Fire Sta,20,47,26,0,93
Wilkes Edward B Pope Center,Edward B Pope Center,20,199,128,0,347
Wilkes Rayle City Hall,Rayle City Hall,11,40,63,0,114
Wilkes Courthouse,Courthouse,28,133,53,1,215
Wilkes Tignall Sch Lunch Rm,Tignall Sch Lunch Rm,30,79,100,0,209
Wilkenson Bloodworth,Bloodworth,1,12,10,0,23
Wilkenson Griffin,Griffin,5,7,16,0,28
Wilkenson High Hill,High Hill,0,11,15,0,26
Wilkenson Irwinton,Irwinton,46,183,86,0,315
Wilkenson Ivey,Ivey,5,33,36,0,74
Wilkenson Lord,Lord,19,76,108,0,203
Wilkenson Midway,Midway,56,211,163,0,430
Wilkenson Ramah,Ramah,65,227,252,1,545
Wilkenson Turkey Creek,Turkey Creek,6,23,55,0,84
Worth Sylvester ,Sylvester ,85,530,303,0,918
Worth Scooterville ,Scooterville ,5,12,9,0,26
Worth Minton,Minton,8,33,21,0,62
Worth Bridgeboro,Bridgeboro,4,49,44,1,98
Worth County Line,County Line,10,31,24,0,65
Worth Isabella ,Isabella ,3,39,20,0,62
Worth Sylvester East,Sylvester East,12,100,50,0,162
Worth Poulan ,Poulan ,9,47,29,0,85
Worth Sumner,Sumner,9,37,43,1,90
Worth Red Rock,Red Rock,8,72,49,0,129
Worth Doles,Doles,2,9,9,0,20
Worth Warwick,Warwick,26,20,79,0,125
